Id,Label,timeset,indegree,outdegree,Degree,modularity_class,clustering,componentnumber,strongcompnum,weighted indegree,weighted outdegree,Weighted Degree,Eccentricity,closnesscentrality,harmonicclosnesscentrality,betweenesscentrality
A Committee of Congress,,,0,16,16,25,0.029167,0,522,0,26,26,7,0.270574,0.299184,0
Agents for Vermont,,,1,0,1,25,0,0,521,1,0,1,0,0,0,0
Maryland Delegates,,,0,12,12,0,0.015152,0,530,0,53,53,9,0.149772,0.16752,0
Assembly of Maryland,,,1,0,1,0,0,0,529,1,0,1,0,0,0,0
John Hancock,,,7,73,80,25,0.006494,0,519,11,214,225,6,0.331627,0.401903,24304.386863
Baltimore Committee,,,1,0,1,25,0,0,465,1,0,1,0,0,0,0
Board of War,,,0,13,13,25,0.032051,0,537,0,32,32,7,0.256661,0.290545,0
Board of Admiralty,,,1,1,2,25,0,0,536,1,1,2,1,1,1,1
North Carolina Delegates,,,1,9,10,14,0.027778,0,519,2,30,32,6,0.277635,0.312088,1350.354762
Board of Treasury,,,4,2,6,1,0.1,0,519,8,2,10,8,0.208092,0.224295,677.691517
Pennsylvania Delegates,,,0,9,9,6,0,0,543,0,15,15,7,0.224588,0.246971,0
Charles Thomson,,,6,83,89,1,0.008755,0,519,9,194,203,5,0.385944,0.454835,33780.524219
John Wirspoon,,,0,15,15,15,0.038095,0,547,0,20,20,6,0.296903,0.332873,0
British Commissioners,,,2,0,2,15,0.5,0,479,2,0,2,0,0,0,0
Richard Henry Lee,,,18,35,53,5,0.022202,0,519,47,98,145,6,0.329268,0.382742,41557.343095
New York Delegates,,,1,19,20,2,0.005263,0,451,1,65,66,2,0.952381,0.975,3292.288997
Chairman and Freeholders of Dutchess County,,,1,0,1,2,0,0,450,1,0,1,0,0,0,0
Andrew Allen,,,0,2,2,2,0,0,549,0,2,2,7,0.226008,0.238842,0
Chairman of Pennsylvania Committee of Safety,,,1,0,1,2,0,0,548,1,0,1,0,0,0,0
Massachusetts Delegates,,,0,12,12,12,0.022727,0,553,0,29,29,7,0.259968,0.297886,0
Chevalier de la Luzerne,,,4,0,4,25,0.083333,0,94,8,0,8,0,0,0,0
John Sullivan,,,16,10,26,24,0.043333,0,519,29,48,77,7,0.26203,0.295304,11619.727566
Samuel Huntington,,,14,58,72,25,0.019462,0,519,49,201,250,6,0.315482,0.384902,29464.485161
Thomas McKean,,,3,37,40,25,0.020243,0,519,4,73,77,6,0.326448,0.374383,13929.273241
Henry Laurens,,,9,109,118,15,0.006998,0,519,12,357,369,5,0.379391,0.469419,41614.737629
Chevalier de Laneuville,,,1,0,1,15,0,0,294,2,0,2,0,0,0,0
Committee at Headquarters,,,2,27,29,25,0.025132,0,519,11,59,70,6,0.300557,0.34231,3291.914714
Commissary-General of Issues,,,1,0,1,25,0,0,408,1,0,1,0,0,0,0
Committee of Commerce,,,0,1,1,1,0,0,554,0,1,1,1,1,1,0
Commissioners at Paris,,,4,0,4,1,0.083333,0,482,9,0,9,0,0,0,0
Committee of Foreign Affairs,,,0,11,11,1,0.009091,0,562,0,20,20,7,0.245877,0.272924,0
Committee of Secret Correspondence,,,1,6,7,1,0.071429,0,519,1,13,14,8,0.206172,0.22293,125.505628
Robert Morris,,,16,20,36,1,0.046371,0,519,40,28,68,6,0.342314,0.385417,32302.943595
James Wilson,,,5,5,10,6,0.011111,0,519,5,7,12,6,0.299031,0.321219,5241.74116
Commissioners for Indian Affairs,,,1,0,1,6,0,0,347,1,0,1,0,0,0,0
Commissioners for Indian Affairs of Middle Department,,,1,0,1,1,0,0,345,1,0,1,0,0,0,0
Commissioners for Indian Affairs of Norrn Department,,,1,0,1,1,0,0,344,1,0,1,0,0,0,0
Commissioners from Maryland,,,1,0,1,25,0,0,464,1,0,1,0,0,0,0
Commissioners in Paris,,,4,0,4,1,0,0,343,6,0,6,0,0,0,0
Secret Committee,,,0,9,9,1,0.027778,0,564,0,11,11,7,0.269374,0.29289,0
Commissioners of Navy Board of Eastern Department,,,1,0,1,25,0,0,535,1,0,1,0,0,0,0
Committee for City and County of Albany,,,1,0,1,2,0,0,449,1,0,1,0,0,0,0
Committee in Philadelphia,,,1,5,6,25,0.1,0,519,3,11,14,7,0.265031,0.290961,439.333333
Committee of Baltimore,,,1,0,1,0,0,0,528,1,0,1,0,0,0,0
Committee of Correspondence of Cumberland County,,,1,0,1,6,0,0,542,1,0,1,0,0,0,0
Stephen Mix Mitchell,,,0,4,4,21,0,0,576,0,11,11,7,0.203014,0.21917,0
Committee of Pay-Table,,,1,0,1,21,0,0,575,1,0,1,0,0,0,0
New Hampshire Delegates,,,0,7,7,24,0.047619,0,579,0,19,19,9,0.173323,0.18834,0
Committee of Safety,,,2,0,2,2,0,0,448,5,0,5,0,0,0,0
Henry Marchant,,,0,8,8,34,0,0,584,0,21,21,8,0.209496,0.231178,0
Company of Rhode Island,,,1,0,1,34,0,0,583,1,0,1,0,0,0,0
Comte de Grasse,,,1,0,1,25,0,0,516,2,0,2,0,0,0,0
Comte de Rochambeau,,,3,0,3,25,0,0,400,4,0,4,0,0,0,0
Continental Congress,,,1,2,3,15,0,0,293,1,2,3,1,1,1,474.55
Convention of Maryland,,,1,0,1,25,0,0,462,1,0,1,0,0,0,0
William Paca,,,1,6,7,0,0.02381,0,585,1,6,7,9,0.148698,0.160066,5.25
Council of Maryland,,,2,0,2,0,0,0,525,2,0,2,0,0,0,0
Eastern States,,,2,0,2,25,1,0,399,2,0,2,0,0,0,0
Governor of Georgia,,,1,0,1,1,0,0,342,4,0,4,0,0,0,0
Governor of Maryland,,,3,0,3,0,0,0,527,3,0,3,0,0,0,0
David Ross,,,0,1,1,0,0,0,586,0,1,1,1,1,1,0
Governor of North Carolina,,,1,0,1,1,0,0,341,4,0,4,0,0,0,0
Governor of Rhode Island,,,1,0,1,34,0,0,582,1,0,1,0,0,0,0
Governor of South Carolina,,,1,0,1,1,0,0,340,3,0,3,0,0,0,0
Inhabitants of Kaskaskias,,,1,0,1,1,0,0,339,1,0,1,0,0,0,0
Judges appointed in Case of South Carolina vs. Georgia,,,1,0,1,1,0,0,338,1,0,1,0,0,0,0
Judges of Court of Appeals,,,1,0,1,1,0,0,337,1,0,1,0,0,0,0
George Ross,,,2,2,4,6,0,0,540,2,2,4,7,0.230742,0.241744,403.448677
Lancaster Committee of Correspondence,,,1,0,1,6,0,0,539,1,0,1,0,0,0,0
Lancaster County Committee,,,1,0,1,6,0,0,541,1,0,1,0,0,0,0
Marquis de Bouille,,,1,0,1,25,0,0,398,1,0,1,0,0,0,0
Marquis de Lafayette,,,5,0,5,15,0,0,141,22,0,22,0,0,0,0
Henry- Laurens,,,0,1,1,15,0,0,587,0,1,1,1,1,1,0
John Hanson,,,1,8,9,25,0,0,589,1,14,15,7,0.197689,0.216857,95.907143
John Jay,,,14,27,41,2,0.034413,0,519,28,50,78,6,0.284211,0.319985,11321.638259
Maryland Assembly,,,2,0,2,25,0,0,461,6,0,6,0,0,0,0
Maryland Convention,,,1,0,1,25,0,0,460,3,0,3,0,0,0,0
Maryland Convention or Committee of Safety,,,1,0,1,25,0,0,534,1,0,1,0,0,0,0
Maryland Council,,,1,0,1,0,0,0,526,1,0,1,0,0,0,0
Maryland Council of Safety,,,11,0,11,0,0.036364,0,198,36,0,36,0,0,0,0
Charles Carroll,,,0,2,2,0,0,0,590,0,2,2,8,0.17339,0.18291,0
Matthew Tilghman,,,2,1,3,25,0,0,380,3,1,4,1,1,1,27.883802
Robert Alexander,,,0,1,1,0,0,0,591,0,3,3,1,1,1,0
Samuel Chase,,,2,8,10,0,0.077778,0,519,5,31,36,6,0.269888,0.296168,507.171333
Thomas Johnson jr.,,,21,3,24,0,0.035573,0,519,60,3,63,8,0.173308,0.183449,6558.784178
Thomas Stone,,,0,2,2,0,0,0,592,0,2,2,8,0.17339,0.18291,0
Elbridge Gerry,,,11,20,31,21,0.058201,0,519,46,65,111,6,0.319055,0.357562,11421.619879
Massachusetts Assembly,,,4,0,4,25,0.166667,0,212,11,0,11,0,0,0,0
Massachusetts Council,,,2,0,2,25,0,0,459,7,0,7,0,0,0,0
Thomas Cushing,,,0,4,4,21,0,0,594,0,6,6,7,0.2429,0.260703,0
Massachusetts Provincial Congress,,,1,0,1,25,0,0,458,2,0,2,0,0,0,0
John Maws,,,4,10,14,25,0.096154,0,519,7,40,47,7,0.268434,0.298137,2580.363967
Medical Committee,,,1,2,3,25,0.166667,0,519,1,2,3,7,0.196662,0.210001,308
Navy Board,,,1,0,1,15,0,0,290,1,0,1,0,0,0,0
Navy Board of Eastern Department,,,1,0,1,1,0,0,561,1,0,1,0,0,0,0
New Hampshire Assembly,,,1,0,1,25,0,0,457,3,0,3,0,0,0,0
Josiah Bartlett,,,7,7,14,24,0.068182,0,519,61,41,102,7,0.211488,0.22773,3046.909524
New Hampshire Committee of Safety,,,1,0,1,24,0,0,96,3,0,3,0,0,0,0
New Hampshire Convention,,,1,0,1,25,0,0,456,2,0,2,0,0,0,0
New Hampshire Convention or Committee of Safety,,,1,0,1,24,0,0,95,1,0,1,0,0,0,0
New Hampshire Provincial Committee,,,1,0,1,24,0,0,578,1,0,1,0,0,0,0
New Jersey Assembly,,,1,0,1,25,0,0,455,1,0,1,0,0,0,0
New Jersey Convention,,,1,0,1,25,0,0,454,3,0,3,0,0,0,0
New Jersey Provincial Convention,,,1,0,1,25,0,0,453,1,0,1,0,0,0,0
New York Assembly,,,1,0,1,25,0,0,452,1,0,1,0,0,0,0
Francis Lewis,,,0,13,13,2,0.032051,0,597,0,24,24,6,0.270911,0.297107,0
New York Committee of Safety,,,3,0,3,2,0,0,140,9,0,9,0,0,0,0
402.Francis Lewis,,,0,1,1,2,0,0,598,0,1,1,1,1,1,0
New York Convention,,,6,0,6,2,0.033333,0,265,18,0,18,0,0,0,0
James Duane,,,3,30,33,2,0.03629,0,519,5,113,118,6,0.313346,0.360648,5631.472398
John Alsop,,,0,1,1,2,0,0,599,0,1,1,1,1,1,0
Philip Livingston,,,0,2,2,2,0,0,603,0,3,3,2,0.666667,0.75,0
New York Council of Safety,,,2,0,2,2,0,0,264,6,0,6,0,0,0,0
Committee of Philadelphia,,,0,1,1,2,0,0,604,0,1,1,1,1,1,0
New York Provincial Congress,,,5,0,5,2,0.05,0,263,8,0,8,0,0,0,0
Henry Wisner,,,0,1,1,2,0,0,605,0,1,1,1,1,1,0
Delegates of North Carolina,,,0,1,1,14,0,0,606,0,1,1,1,1,1,0
North Carolina Assembly,,,3,0,3,14,0,0,146,5,0,5,0,0,0,0
Thomas Burke,,,5,17,22,14,0.028947,0,519,13,58,71,5,0.309603,0.346091,7497.730556
Timothy Bloodworth,,,0,2,2,14,0,0,607,0,7,7,1,1,1,0
North Carolina Convention,,,1,0,1,25,0,0,439,1,0,1,0,0,0,0
John Penn,,,1,8,9,14,0.041667,0,519,1,18,19,6,0.268657,0.290818,925.456984
North Carolina Council of Safety,,,2,0,2,14,0,0,240,6,0,6,0,0,0,0
North Carolina General Assembly,,,1,0,1,14,0,0,288,1,0,1,0,0,0,0
William Hooper,,,0,9,9,14,0.013889,0,612,0,15,15,6,0.265879,0.288923,0
North Carolina Provincial Congress,,,1,0,1,14,0,0,611,1,0,1,0,0,0,0
Officer Commanding in Philadelphia,,,1,0,1,25,0,0,438,2,0,2,0,0,0,0
Officers of New Hampshire Line,,,1,0,1,24,0,0,93,1,0,1,0,0,0,0
Pennsylvania Committee of Safety,,,1,0,1,25,0,0,437,1,0,1,0,0,0,0
Pennsylvania Council,,,4,0,4,25,0,0,436,4,0,4,0,0,0,0
Thomas Smith,,,0,1,1,25,0,0,613,0,1,1,1,1,1,0
Pennsylvania Council of Safety,,,1,0,1,25,0,0,533,1,0,1,0,0,0,0
Postmaster at Philadelphia,,,1,0,1,1,0,0,336,1,0,1,0,0,0,0
William Irvine,,,7,4,11,6,0.036364,0,519,9,4,13,7,0.231263,0.244059,4154.842474
President of Congress (Arthur St. Clair),,,1,0,1,6,0,0,348,1,0,1,0,0,0,0
James White,,,0,8,8,14,0.089286,0,616,0,11,11,6,0.287912,0.315674,0
President of Congress (Nathaniel Gorham),,,1,0,1,14,0,0,615,1,0,1,0,0,0,0
Artemas Ward,,,1,1,2,25,0,0,430,2,1,3,1,1,1,308
President of Massachusetts Council,,,2,0,2,12,0,0,429,2,0,2,0,0,0,0
President of New Hampshire,,,1,0,1,24,0,0,577,1,0,1,0,0,0,0
President of New York Congress,,,1,0,1,25,0,0,435,1,0,1,0,0,0,0
President of North Carolina Convention,,,1,0,1,14,0,0,610,1,0,1,0,0,0,0
President of Pennsylvania,,,1,0,1,25,0,0,397,1,0,1,0,0,0,0
President of Pennsylvania Committee of Safety,,,1,0,1,1,0,0,335,1,0,1,0,0,0,0
President of United States (George Washington ),,,1,0,1,1,0,0,334,1,0,1,0,0,0,0
Provincial Congress,,,1,0,1,2,0,0,447,6,0,6,0,0,0,0
Quartermaster-General,,,1,0,1,25,0,0,407,1,0,1,0,0,0,0
Reverend John Ettwein,,,1,0,1,1,0,0,333,4,0,4,0,0,0,0
Rhode Island Assembly,,,1,0,1,34,0,0,581,3,0,3,0,0,0,0
South Carolina Delegates,,,0,9,9,15,0.027778,0,620,0,16,16,7,0.22694,0.249598,0
Secret Committee at Charleston,,,1,0,1,15,0,0,619,1,0,1,0,0,0,0
Several States,,,8,0,8,25,0.107143,0,139,68,0,68,0,0,0,0
President of Congress (Thomas McKean),,,0,1,1,25,0,0,621,0,1,1,1,1,1,0
South Carohna Delegates,,,1,0,1,14,0,0,287,1,0,1,0,0,0,0
Speaker of House of Representatives,,,1,0,1,12,0,0,552,1,0,1,0,0,0,0
Special Council of Eastern Shore of Maryland,,,1,0,1,25,0,0,532,1,0,1,0,0,0,0
State of Delaware,,,3,0,3,25,0.5,0,332,3,0,3,0,0,0,0
State of Maryland,,,2,0,2,25,1,0,396,2,0,2,0,0,0,0
State of New Hampshire,,,3,0,3,25,0.333333,0,395,4,0,4,0,0,0,0
State of New Jersey,,,1,0,1,25,0,0,515,2,0,2,0,0,0,0
State of North Carolina,,,1,0,1,1,0,0,331,1,0,1,0,0,0,0
State of Pennsylvania,,,3,0,3,25,0.333333,0,394,6,0,6,0,0,0,0
State of Rhode Island,,,1,0,1,1,0,0,330,1,0,1,0,0,0,0
State of Virginia,,,2,0,2,25,0,0,406,3,0,3,0,0,0,0
States from New Hampshire,,,1,0,1,25,0,0,393,1,0,1,0,0,0,0
States from New Hampshire to Maryland,,,1,0,1,25,0,0,405,1,0,1,0,0,0,0
States from New Hampshire to Virginia,,,1,0,1,25,0,0,404,2,0,2,0,0,0,0
Thirteen States,,,1,0,1,25,0,0,434,1,0,1,0,0,0,0
Virginia Assembly,,,1,0,1,25,0,0,433,1,0,1,0,0,0,0
Edmund Randolph,,,8,7,15,13,0.090476,0,519,78,9,87,8,0.233514,0.254371,2699.507404
Virginia State Auditors,,,2,0,2,13,0,0,165,2,0,2,0,0,0,0
Joseph Jones,,,1,7,8,13,0.142857,0,519,11,25,36,7,0.248752,0.272307,339.75
.Statement,,,1,0,1,1,0,0,481,1,0,1,0,0,0,0
a Committee of Citizens of Philadelphia,,,1,0,1,25,0,0,403,1,0,1,0,0,0,0
a Committee of Congress,,,2,0,2,24,0,0,138,2,0,2,0,0,0,0
a Committee of Massachusetts Assembly,,,1,0,1,21,0,0,211,1,0,1,0,0,0,0
a Continental Officer,,,1,0,1,25,0,0,432,1,0,1,0,0,0,0
Member of Congress,,,0,1,1,3,0,1,623,0,1,1,1,1,1,0
a Gentleman in London,,,1,0,1,3,0,1,622,1,0,1,0,0,0,0
Benjamin Hawkins,,,1,3,4,14,0.083333,0,519,1,7,8,8,0.207095,0.225698,317.123016
Abner Nash,,,2,0,2,14,0,0,326,5,0,5,0,0,0,0
Willie Jones,,,0,1,1,14,0,0,624,0,3,3,1,1,1,0
Abraham Ten Broeck,,,4,0,4,2,0,0,446,8,0,8,0,0,0,0
Lewis Morris,,,0,3,3,2,0,0,625,0,3,3,7,0.222602,0.238815,0
William Duer,,,1,7,8,2,0.071429,0,626,1,10,11,6,0.269406,0.291089,649
Abraham Yates jr.,,,2,2,4,2,0,0,602,3,2,5,1,1,1,4
Abstract of Debates,,,2,0,2,14,0,0,145,15,0,15,0,0,0,0
Thomas Wirke,,,0,1,1,14,0,0,627,0,1,1,1,1,1,0
Address before Committee on state Rights of Colonies,,,1,0,1,2,0,0,262,1,0,1,0,0,0,0
Nathan Dane,,,5,17,22,12,0.022876,0,519,7,26,33,7,0.25542,0.288158,5705.22553
Address before Massachusetts House of Representatives,,,2,0,2,12,1,0,301,2,0,2,0,0,0,0
Rufus King,,,4,12,16,21,0.083333,0,519,9,46,55,6,0.275276,0.307227,3244.734915
George Read,,,7,2,9,25,0.027778,0,15,12,8,20,1,1,1,630
Airs. Read,,,1,0,1,25,0,0,14,1,0,1,0,0,0,0
Alexander Contee Hanson,,,1,0,1,1,0,0,329,2,0,2,0,0,0,0
Arthur St. Clair,,,33,52,85,4,0.004829,0,519,58,122,180,5,0.32111,0.383925,71241.923181
Alexander Hamilton,,,3,1,4,4,0.083333,0,519,4,1,5,7,0.242152,0.257393,2529.881371
Philip Schuyler,,,15,12,27,2,0.070769,0,519,62,29,91,6,0.291105,0.319084,9131.799252
Alexander James Dallas,,,1,0,1,25,0,0,514,1,0,1,0,0,0,0
Alexander Martin,,,2,0,2,14,0,0,286,8,0,8,0,0,0,0
Hugh Williamson,,,1,6,7,14,0.047619,0,572,1,23,24,7,0.233464,0.252534,259.889286
Alexander McDougal,,,1,0,1,25,0,0,392,1,0,1,0,0,0,0
Alexander McDougall,,,1,1,2,2,0.5,0,137,1,1,2,2,0.666667,0.75,0
Alexander Scammell,,,1,0,1,24,0,0,92,1,0,1,0,0,0,0
Samuel Johnston,,,8,3,11,14,0.045455,0,519,37,12,49,6,0.237363,0.253832,3150.544841
Allen Jones,,,1,1,2,14,0,0,285,1,1,2,1,1,1,2
James Madison,,,13,22,35,13,0.031034,0,519,51,143,194,6,0.280763,0.314763,7351.779792
Ambrose Madison,,,1,0,1,13,0,0,213,1,0,1,0,0,0,0
Oliver Wolcott,,,8,15,23,21,0.047368,0,519,15,48,63,6,0.290323,0.327829,11049.342602
Andrew Adams,,,2,4,6,21,0.25,0,519,2,7,9,7,0.225391,0.243217,1.916667
Roger Sherman,,,1,15,16,21,0.079167,0,519,1,44,45,6,0.285086,0.313863,1302.252128
Benjamin Huntington,,,0,2,2,21,0,0,628,0,2,2,10,0.146534,0.156854,0
Andrew Huntington,,,2,0,2,21,0,0,156,2,0,2,0,0,0,0
Jeremiah Wadsworth,,,14,1,15,21,0.033333,0,157,23,1,24,1,1,1,310
Andrew Lewis,,,1,0,1,25,0,0,431,1,0,1,0,0,0,0
Anthony Wayne,,,3,1,4,4,0,0,519,6,2,8,6,0.243152,0.265303,680.75303
Benjamin Rush,,,4,5,9,12,0.013889,0,519,5,16,21,7,0.267769,0.286721,1493.206319
John Adams,,,10,36,46,5,0.033298,0,519,38,173,211,6,0.294948,0.341795,10139.985595
Archibald Bulloch,,,2,0,2,5,0,0,210,2,0,2,0,0,0,0
George Rogers Clark,,,58,40,98,13,0.003609,0,519,111,65,176,7,0.255621,0.3051,44828.537723
Archibald Lochry,,,1,1,2,13,0,0,519,1,1,2,8,0.203646,0.222571,0
John Brown,,,2,3,5,13,0.166667,0,519,3,5,8,7,0.235123,0.254508,2855.65985
Archibald Stuart,,,1,0,1,13,0,0,166,1,0,1,0,0,0,0
Artemus Ward,,,1,0,1,25,0,0,428,1,0,1,0,0,0,0
Arthur Lee,,,8,3,11,5,0.1,0,519,31,5,36,7,0.240267,0.259303,1417.037229
Francis Lightfoot Lee,,,1,6,7,5,0.066667,0,519,4,16,20,7,0.252533,0.275841,251.262887
James Lovell,,,2,31,33,5,0.052419,0,519,2,193,195,6,0.345416,0.394187,4104.530733
John Dickinson,,,7,9,16,4,0.044872,0,519,23,14,37,7,0.274926,0.299478,4929.513471
Ralph Izard,,,1,3,4,1,0,0,559,2,3,5,8,0.198777,0.211024,5.9
Arthur Middleton,,,2,2,4,1,0,0,519,2,2,4,8,0.202247,0.213358,804.544048
Bartholomew Tardiveau,,,0,1,1,4,0,0,629,0,1,1,6,0.243345,0.265665,0
Captain de Luziere,,,0,1,1,4,0,0,630,0,1,1,6,0.243345,0.265665,0
Chevalier Duportail,,,0,1,1,4,0,0,631,0,1,1,6,0.243345,0.265665,0
Colonel Gouvion,,,0,1,1,4,0,0,632,0,1,1,6,0.243345,0.265665,0
Edmund M. Butler,,,1,1,2,4,0,0,519,1,1,2,6,0.243152,0.265303,0
General Butler,,,2,1,3,4,1,0,519,7,4,11,6,0.243152,0.265303,0
George Washington,,,65,5,70,25,0.028559,0,519,402,8,410,6,0.243792,0.269162,41291.2581
Governor Gayoso,,,0,1,1,4,0,0,633,0,1,1,6,0.243345,0.265665,0
Henry Knox,,,14,4,18,4,0.066667,0,519,73,21,94,6,0.265031,0.286883,5051.877255
Isaac B. Dunn,,,0,1,1,4,0,0,634,0,1,1,6,0.243345,0.265665,0
James Gardoqui,,,1,1,2,4,0,0,519,1,1,2,6,0.243152,0.265303,0
James Wilkinson,,,1,1,2,4,0,0,519,1,2,3,6,0.243152,0.265303,0
Joel Barlow,,,0,1,1,4,0,0,635,0,2,2,6,0.243345,0.265665,0
Josiah Harmar,,,5,8,13,4,0.072727,0,519,5,44,49,6,0.293744,0.320808,5264.941223
Judge Parsons,,,0,1,1,4,0,0,636,0,1,1,6,0.243345,0.265665,0
Judge Parsons and Judge Varnum,,,1,1,2,4,0,0,519,5,1,6,6,0.243152,0.265303,0
Judge Symmes,,,2,1,3,4,0.5,0,519,2,1,3,6,0.243152,0.265303,644
Judge Turner,,,1,1,2,4,0,0,519,6,1,7,6,0.243152,0.265303,0
Judges Symmes and Turner,,,0,1,1,4,0,0,637,0,1,1,6,0.243345,0.265665,0
Major Ferguson,,,0,1,1,4,0,0,638,0,1,1,6,0.243345,0.265665,0
Major Hamtramck,,,2,1,3,4,1,0,519,3,2,5,6,0.243152,0.265303,0
P. Gibault,,,0,1,1,4,0,0,639,0,1,1,6,0.243345,0.265665,0
Paul Jones,,,0,1,1,4,0,0,640,0,1,1,6,0.243345,0.265665,0
R. K. Meade,,,0,1,1,4,0,0,641,0,1,1,6,0.243345,0.265665,0
Thomas Fitzsimmons,,,6,1,7,13,0.133333,0,519,10,1,11,6,0.243152,0.265303,2332.201598
Timothy Pickering,,,7,1,8,13,0.071429,0,519,12,1,13,6,0.243152,0.265303,989.63348
Tobias Lear,,,0,1,1,4,0,0,642,0,1,1,6,0.243345,0.265665,0
William Knox,,,0,1,1,4,0,0,643,0,1,1,6,0.243345,0.265665,0
William St. Clair,,,1,1,2,4,0,0,519,1,2,3,6,0.243152,0.265303,0
Attorney-General,,,1,0,1,4,0,0,374,1,0,1,0,0,0,0
Augustin Alottin de La Balme,,,1,0,1,5,0,0,190,1,0,1,0,0,0,0
Azariah Dunham,,,1,0,1,25,0,0,402,1,0,1,0,0,0,0
Azariah Horton,,,1,0,1,1,0,0,328,1,0,1,0,0,0,0
Baron de Kalb,,,1,0,1,15,0,0,283,3,0,3,0,0,0,0
Baron de Knobelauch,,,1,0,1,5,0,0,478,1,0,1,0,0,0,0
Baron Steuben,,,1,0,1,15,0,0,282,6,0,6,0,0,0,0
Benedict Arnold,,,2,0,2,15,0,0,281,2,0,2,0,0,0,0
Beniamin Franklin,,,1,0,1,5,0,0,189,1,0,1,0,0,0,0
Benj amin Franklin,,,1,0,1,2,0,0,136,1,0,1,0,0,0,0
Samuel Adams,,,9,30,39,5,0.048739,0,519,60,104,164,6,0.315328,0.36142,14829.900873
Benjamin Austin,,,1,0,1,5,0,0,469,1,0,1,0,0,0,0
Benjamin Bankson,,,1,0,1,1,0,0,327,6,0,6,0,0,0,0
James Mitchell Varnum,,,0,7,7,34,0.047619,0,645,0,16,16,7,0.211451,0.228282,0
Benjamin Bourne,,,1,0,1,34,0,0,644,1,0,1,0,0,0,0
Benjamin Franklin,,,17,10,27,6,0.029231,0,519,42,12,54,6,0.261501,0.285417,15614.553257
Committee of Foreign Afifairs,,,0,3,3,6,0.166667,0,646,0,4,4,7,0.25,0.27443,0
Marine Committee,,,0,5,5,6,0,0,647,0,5,5,7,0.218194,0.236766,0
Charles Carroll of Carrollton,,,0,4,4,0,0.166667,0,648,0,5,5,7,0.222754,0.24102,0
Charles Pettit,,,2,6,8,6,0.035714,0,519,2,10,12,7,0.245362,0.262507,491.278508
Cyrus Griffin,,,1,9,10,13,0.122222,0,519,1,24,25,7,0.270564,0.295132,99.234127
Daniel of St. Thomas Jenifer,,,7,7,14,0,0.019231,0,519,8,18,26,7,0.209302,0.226066,9380.920744
Daniel Roberdeau,,,0,11,11,6,0.018182,0,652,0,26,26,7,0.257402,0.287613,0
John Armstrong jr.,,,0,4,4,6,0,0,655,0,4,4,7,0.208307,0.221943,0
Samuel Himtington,,,0,1,1,6,0,0,656,0,1,1,7,0.207547,0.218347,0
Virginia Delegates,,,0,13,13,13,0.051282,0,659,0,88,88,7,0.249712,0.275993,0
Benjamin Harrison,,,7,4,11,13,0.2,0,519,40,6,46,7,0.283465,0.309355,13376.798051
James Mercer,,,0,1,1,13,0,0,660,0,1,1,8,0.221124,0.233287,0
Patrick Henry,,,10,5,15,5,0.126374,0,519,34,12,46,8,0.225784,0.248128,2048.625193
Benjamin Harrison ( ?),,,1,0,1,14,0,0,118,1,0,1,0,0,0,0
Benjamin Harwood,,,1,0,1,25,0,0,391,1,0,1,0,0,0,0
Benjamin Hiarrison,,,1,0,1,13,0,0,658,1,0,1,0,0,0,0
Benjamin Hichborn,,,1,0,1,5,0,0,209,1,0,1,0,0,0,0
Benjamin Kent,,,1,0,1,5,0,0,208,1,0,1,0,0,0,0
Benjamin Lincoln,,,12,0,12,25,0.060606,0,119,16,0,16,0,0,0,0
Samuel Alleyne Otis,,,1,6,7,12,0.071429,0,519,2,12,14,7,0.231677,0.254516,1547.767388
Thomas Bee,,,3,2,5,25,0.05,0,120,9,2,11,2,0.75,0.833333,14.5
David Ramsay,,,0,2,2,12,0,0,661,0,3,3,7,0.227959,0.24041,0
John Witherspoon,,,0,1,1,12,0,0,662,0,1,1,8,0.21147,0.220781,0
Tench Coxe,,,1,3,4,13,0,0,519,1,5,6,7,0.238674,0.253788,325.208333
Benjamin Trumbull,,,1,0,1,21,0,0,389,1,0,1,0,0,0,0
Benjamin Walker,,,1,0,1,1,0,0,325,1,0,1,0,0,0,0
Beverley Randolph,,,7,0,7,13,0.047619,0,303,11,0,11,0,0,0,0
Edward Carrington,,,0,8,8,13,0.142857,0,663,0,34,34,6,0.268182,0.290293,0
Henry Lee jr.,,,0,3,3,13,0,0,664,0,4,4,9,0.189988,0.202405,0
John Dawson,,,0,2,2,13,0,0,665,0,2,2,7,0.219702,0.23435,0
William Grayson,,,2,9,11,13,0.177778,0,519,2,20,22,6,0.288513,0.314172,414.494906
Brigadier-General Scott,,,1,0,1,4,0,0,373,2,0,2,0,0,0,0
Caesar A. Rodney,,,1,0,1,25,0,0,513,1,0,1,0,0,0,0
A. George Read,,,0,1,1,25,0,0,666,0,1,1,3,0.409091,0.462963,0
Caesar Rodney,,,6,3,9,25,0.089286,0,16,17,17,34,2,0.615385,0.6875,430.422763
Thomas Rodney,,,5,4,9,12,0.089286,0,16,18,19,37,3,0.571429,0.708333,666.052597
Abraham Clark,,,0,15,15,15,0.009524,0,677,0,26,26,7,0.22339,0.249913,0
Caleb Camp,,,2,0,2,15,0,0,676,2,0,2,0,0,0,0
Frederick Frelinghuysen,,,0,1,1,15,0,0,678,0,1,1,1,1,1,0
Caleb Davis,,,2,0,2,12,0.5,0,300,2,0,2,0,0,0,0
Theodore Sedgwick,,,1,2,3,12,0,0,519,1,2,3,8,0.203646,0.218487,308
Caleb Strong,,,1,0,1,12,0,0,79,1,0,1,0,0,0,0
Captain Bell,,,1,0,1,5,0,0,188,1,0,1,0,0,0,0
Captain Josiah,,,1,0,1,5,0,0,187,1,0,1,0,0,0,0
Winthrop Sargent,,,2,4,6,4,0.166667,0,519,3,4,7,7,0.196185,0.210351,622.666667
Captain Pierce,,,1,0,1,4,0,0,66,1,0,1,0,0,0,0
Chairman of Congress (David Ramsay),,,0,1,1,1,0,0,679,0,1,1,1,1,1,0
Certain States,,,6,0,6,1,0.1,0,324,12,0,12,0,0,0,0
Certain Traders,,,1,0,1,13,0,0,501,1,0,1,0,0,0,0
Certificate,,,2,0,2,13,0,0,427,2,0,2,0,0,0,0
Charles Biddle,,,1,0,1,6,0,0,161,1,0,1,0,0,0,0
Charles Chauncy,,,1,0,1,5,0,0,468,2,0,2,0,0,0,0
Charles Cotesworth Pinckney,,,1,0,1,1,0,0,144,1,0,1,0,0,0,0
Charles Lee,,,3,0,3,5,0,0,159,10,0,10,0,0,0,0
Theodorick Bland,,,3,4,7,13,0.166667,0,519,3,8,11,7,0.275393,0.297858,1299.142613
Charles Pinckney,,,1,2,3,1,0,0,519,3,2,5,6,0.27883,0.300823,308
Charles Preston,,,1,0,1,25,0,0,426,1,0,1,0,0,0,0
Dyre Kearny,,,0,1,1,1,0,0,680,0,1,1,6,0.27878,0.300103,0
Jacob Read,,,1,2,3,1,0,0,519,1,4,5,6,0.27883,0.300823,308
John Montgomery,,,2,4,6,6,0.133333,0,519,3,6,9,6,0.297521,0.326466,1236.641503
Charles W. F. Dumas,,,1,0,1,5,0,0,186,1,0,1,0,0,0,0
Chief of the Winnebago,,,1,0,1,13,0,0,500,1,0,1,0,0,0,0
Joseph Bowman,,,0,5,5,13,0,0,685,0,6,6,8,0.204831,0.227758,0
Chiefs of  Potawatomi,,,1,0,1,13,0,0,684,1,0,1,0,0,0,0
William Sharpe,,,0,7,7,14,0.119048,0,688,0,13,13,6,0.287544,0.312698,0
Christian 02iger,,,1,0,1,14,0,0,687,1,0,1,0,0,0,0
William Ellery,,,1,11,12,34,0.030303,0,695,1,44,45,7,0.245417,0.268169,654
Christopher Ellery,,,1,0,1,34,0,0,694,1,0,1,0,0,0,0
Benjamin Contee,,,0,1,1,7,0,2,697,0,1,1,1,1,1,0
Christopher Richmond,,,1,0,1,7,0,2,696,1,0,1,0,0,0,0
Colonel Sargent,,,0,1,1,8,0,3,699,0,1,1,1,1,1,0
Civil Magistrates and Military Officers at Gallipolis,,,1,0,1,8,0,3,698,1,0,1,0,0,0,0
Colonel Cox,,,1,0,1,2,0,0,135,1,0,1,0,0,0,0
Colonel Darke,,,1,0,1,25,0,0,90,1,0,1,0,0,0,0
William Croghan,,,0,1,1,9,0,4,701,0,1,1,1,1,1,0
Colonel Davics,,,1,0,1,9,0,4,700,1,0,1,0,0,0,0
Colonel Dayton,,,1,0,1,25,0,0,425,1,0,1,0,0,0,0
Colonel Irvine,,,1,0,1,25,0,0,424,1,0,1,0,0,0,0
Colonel Magaw,,,1,0,1,25,0,0,423,1,0,1,0,0,0,0
Colonel Pettit,,,1,0,1,2,0,0,134,1,0,1,0,0,0,0
Colonel Shea,,,1,0,1,25,0,0,422,1,0,1,0,0,0,0
Colonel Sproat,,,1,0,1,4,0,0,372,2,0,2,0,0,0,0
Comfort Sands,,,1,0,1,1,0,0,322,1,0,1,0,0,0,0
Committee of Correspondence,,,1,0,1,5,0,0,467,1,0,1,0,0,0,0
Committee of Kentucky,,,1,0,1,4,0,0,371,1,0,1,0,0,0,0
Committee Report,,,1,0,1,25,0,0,512,1,0,1,0,0,0,0
Oliver Ellsworth,,,5,5,10,21,0.066667,0,519,9,14,23,9,0.171338,0.187795,1756.500056
Communication to Public,,,1,0,1,21,0,0,350,1,0,1,0,0,0,0
John Laurens,,,8,1,9,15,0.125,0,106,34,1,35,1,1,1,312
Comte d'Estaing,,,1,0,1,15,0,0,105,1,0,1,0,0,0,0
Congress,,,2,0,2,24,0,0,91,3,0,3,0,0,0,0
Conrad Alexandre Gerard,,,1,0,1,2,0,0,133,2,0,2,0,0,0,0
Inhabitants of Kentucky,,,0,1,1,10,0,5,703,0,1,1,1,1,1,0
Convention of Virginia,,,1,0,1,10,0,5,702,1,0,1,0,0,0,0
Cornelius Harnett,,,1,5,6,14,0.05,0,519,1,28,29,6,0.237102,0.254835,639.685714
Council of Pennsylvania,,,1,0,1,25,0,0,390,1,0,1,0,0,0,0
County Lieutenants,,,1,0,1,4,0,0,370,1,0,1,0,0,0,0
Daniel Brodhead,,,2,2,4,13,0.5,0,519,2,7,9,8,0.221918,0.245104,55.352597
Robert George,,,0,5,5,13,0.25,0,704,0,6,6,8,0.204152,0.226337,0
Daniel Mowry,,,0,1,1,11,0,6,706,0,1,1,1,1,1,0
Daniel Manton,,,1,0,1,11,0,6,705,1,0,1,0,0,0,0
Benjamin Rumsey,,,0,2,2,0,1,0,707,0,4,4,8,0.173437,0.183166,0
Daniel Carroll,,,0,5,5,0,0.05,0,708,0,12,12,7,0.204838,0.22447,0
David Espy and Ors,,,1,0,1,15,0,0,280,1,0,1,0,0,0,0
Ezra L'Hommedieu,,,0,3,3,2,0.166667,0,711,0,17,17,8,0.193577,0.205524,0
David Gelston,,,1,0,1,2,0,0,710,1,0,1,0,0,0,0
Edward Hand,,,5,2,7,14,0.066667,0,519,6,2,8,8,0.203774,0.2236,505.628963
David Shepherd,,,1,0,1,14,0,0,32,1,0,1,0,0,0,0
David Wooster,,,2,0,2,25,0,0,388,4,0,4,0,0,0,0
Diary,,,8,0,8,12,0,0,11,432,0,432,0,0,0,0
John Fell,,,0,2,2,12,0,0,712,0,154,154,2,0.666667,0.75,0
Richard Smith,,,0,2,2,12,0,0,713,0,99,99,1,1,1,0
Samuel Holten,,,3,6,9,12,0.027778,0,519,16,95,111,7,0.219141,0.238845,915.740559
Samuel Llolten,,,0,1,1,12,0,0,714,0,1,1,1,1,1,0
Samuel Ward,,,0,4,4,12,0,0,717,0,62,62,1,1,1,0
Diego Joseph Navarro,,,1,0,1,15,0,0,279,1,0,1,0,0,0,0
Draft of Instructions,,,1,0,1,4,0,0,194,1,0,1,0,0,0,0
Draft of Manifesto respecting Henry Laurens,,,1,0,1,2,0,0,261,1,0,1,0,0,0,0
Duncan Campbell,,,1,0,1,25,0,0,421,1,0,1,0,0,0,0
Jonathan Elmer,,,0,2,2,5,0,0,719,0,2,2,1,1,1,0
Ebenezer Elmer,,,1,0,1,5,0,0,718,1,0,1,0,0,0,0
Abraham Baldwin,,,0,3,3,14,0,0,721,0,3,3,8,0.206875,0.22548,0
Ebenezer Hazard,,,1,0,1,14,0,0,720,1,0,1,0,0,0,0
William Whipple,,,6,5,11,24,0.180556,0,519,31,70,101,6,0.256228,0.278318,3206.011946
Ebenezer Thompson,,,1,0,1,24,0,0,480,1,0,1,0,0,0,0
Ebenezer Zane,,,1,0,1,4,0,0,369,1,0,1,0,0,0,0
Edmimd Randolph,,,1,0,1,13,0,0,173,1,0,1,0,0,0,0
Edmund Pendleton,,,3,1,4,13,0.333333,0,164,29,1,30,1,1,1,251.816667
Thomas Jefferson,,,39,15,54,13,0.025098,0,519,139,30,169,7,0.259719,0.297579,31931.899722
Edmutid Randolph,,,1,0,1,13,0,0,170,1,0,1,0,0,0,0
Edward Biddle,,,1,0,1,5,0,0,207,1,0,1,0,0,0,0
Commercial Committee,,,0,5,5,14,0,0,722,0,5,5,7,0.261062,0.281939,0
Committee of Congress,,,0,5,5,25,0,0,724,0,7,7,7,0.203062,0.222919,0
Edward Pullen,,,1,0,1,12,0,0,299,1,0,1,0,0,0,0
Edward Rutledge,,,1,6,7,2,0.166667,0,519,1,11,12,7,0.252435,0.273677,835.544048
Georgia Delegates,,,0,4,4,25,0.083333,0,728,0,5,5,7,0.26461,0.289611,0
Edward Telfair,,,1,1,2,25,0,0,727,1,1,2,1,1,1,1
Egbert Benson,,,1,0,1,15,0,0,278,1,0,1,0,0,0,0
Francis Dana,,,2,2,4,15,0.166667,0,519,4,3,7,7,0.254717,0.270595,282.014539
George Partridge,,,0,1,1,21,0,0,729,0,1,1,7,0.242164,0.257381,0
Jonathan Blanchard,,,0,1,1,21,0,0,730,0,1,1,7,0.242164,0.257381,0
Elias Dayton,,,2,0,2,15,0,0,675,9,0,9,0,0,0,0
Elias Boudinot,,,0,10,10,15,0,0,736,0,21,21,8,0.196525,0.21567,0
Eliphalet Dyer,,,1,10,11,21,0.127273,0,519,1,41,42,7,0.241251,0.263275,2031.073016
El jas Boudinot,,,0,1,1,16,0,7,738,0,1,1,1,1,1,0
Elisha Boudinot,,,2,0,2,16,0,7,737,2,0,2,0,0,0,0
EUias Boudinot,,,0,1,1,16,0,7,739,0,1,1,1,1,1,0
Elisha Paine,,,1,0,1,21,0,0,387,1,0,1,0,0,0,0
Ensign Tillinghast,,,1,0,1,4,0,0,368,1,0,1,0,0,0,0
Ephraim Blaine,,,4,0,4,24,0.083333,0,277,4,0,4,0,0,0,0
Nathaniel Peabody,,,7,8,15,24,0.064103,0,519,8,35,43,6,0.277873,0.311703,6217.26084
Esek Hopkins,,,1,0,1,25,0,0,420,2,0,2,0,0,0,0
Estevan Miro,,,1,0,1,25,0,0,588,1,0,1,0,0,0,0
William Shannon,,,0,4,4,13,0.166667,0,742,0,4,4,8,0.22264,0.247815,0
Evan Baker,,,1,0,1,13,0,0,741,1,0,1,0,0,0,0
Evert Bancker,,,3,0,3,2,0.333333,0,260,3,0,3,0,0,0,0
Eximund Pendleton,,,1,0,1,13,0,0,169,2,0,2,0,0,0,0
Ezekiel Williams,,,1,0,1,21,0,0,354,1,0,1,0,0,0,0
Ezra Stiles,,,1,0,1,34,0,0,693,1,0,1,0,0,0,0
Fox Indians,,,1,0,1,13,0,0,499,1,0,1,0,0,0,0
Francis Bailey,,,1,0,1,15,0,0,276,1,0,1,0,0,0,0
Francis Eppes,,,1,0,1,13,0,0,507,1,0,1,0,0,0,0
Francis Huger,,,1,0,1,15,0,0,275,1,0,1,0,0,0,0
Francis Johnston,,,1,0,1,4,0,0,193,1,0,1,0,0,0,0
French Inhabitants,,,1,0,1,4,0,0,367,1,0,1,0,0,0,0
General Gage,,,1,0,1,5,0,0,466,1,0,1,0,0,0,0
Thomas Quirk,,,0,2,2,13,0.5,0,744,0,2,2,8,0.204146,0.224451,0
Geoffrey Linctot,,,1,3,4,13,0.333333,0,743,1,6,7,8,0.22226,0.246524,100.179762
George Brinker,,,1,0,1,13,0,0,683,1,0,1,0,0,0,0
George Brj'an,,,1,0,1,6,0,0,651,1,0,1,0,0,0,0
George Bryan,,,4,0,4,6,0,0,477,8,0,8,0,0,0,0
Jonathan Bayard Smith,,,0,5,5,6,0,0,746,0,14,14,9,0.171188,0.187268,0
Committee of Conference,,,0,6,6,25,0,0,748,0,24,24,7,0.199816,0.218575,0
George Clinton,,,16,1,17,2,0.088235,0,131,113,4,117,1,1,1,308.5
Gouverneur Morris,,,2,11,13,2,0.163636,0,519,2,32,34,6,0.315636,0.347479,3120.546777
James Monroe,,,5,9,14,13,0.147436,0,519,11,26,37,5,0.301536,0.329064,1840.859403
John Morin Scott,,,0,3,3,2,0,0,749,0,8,8,7,0.196786,0.211387,0
Robert R. Livingston,,,10,5,15,2,0.137363,0,519,33,11,44,7,0.251455,0.271362,1273.109524
William Floyd,,,1,4,5,2,0.2,0,709,1,20,21,7,0.239219,0.259388,647.5
George Clymer,,,1,0,1,15,0,0,274,1,0,1,0,0,0,0
George Galphin,,,1,0,1,15,0,0,273,1,0,1,0,0,0,0
George Ginton,,,3,0,3,2,0.166667,0,259,3,0,3,0,0,0,0
George Handley,,,1,0,1,1,0,0,321,1,0,1,0,0,0,0
George Howell,,,1,0,1,25,0,0,384,1,0,1,0,0,0,0
George Johnstone,,,1,0,1,15,0,0,272,1,0,1,0,0,0,0
George Mason,,,2,0,2,5,0,0,476,3,0,3,0,0,0,0
George Maws,,,1,0,1,1,0,0,320,2,0,2,0,0,0,0
Lambert Cadwalader,,,0,2,2,13,0,0,751,0,2,2,6,0.232226,0.244923,0
George Mitchell,,,1,0,1,13,0,0,750,1,0,1,0,0,0,0
David Lyster,,,0,1,1,17,0,8,753,0,1,1,1,1,1,0
George Moorehead,,,1,0,1,17,0,8,752,1,0,1,0,0,0,0
George Morgan,,,1,0,1,15,0,0,271,1,0,1,0,0,0,0
George Nicholas,,,1,0,1,13,0,0,168,2,0,2,0,0,0,0
George Ointon,,,4,0,4,2,0,0,258,4,0,4,0,0,0,0
George Plater,,,1,1,2,0,0.5,0,524,1,1,2,9,0.147903,0.154102,0
George Qinton,,,7,0,7,2,0.190476,0,129,11,0,11,0,0,0,0
James Sykes,,,0,1,1,25,0,0,754,0,1,1,2,0.6,0.666667,0
Samuel Wharton,,,0,1,1,25,0,0,755,0,1,1,2,0.6,0.666667,0
Arthur Campbell,,,0,1,1,13,0,0,756,0,1,1,8,0.203832,0.222999,0
Battist,,,0,1,1,13,0,0,757,0,1,1,8,0.203832,0.222999,0
Benjamin Logan,,,0,1,1,13,0,0,758,0,1,1,8,0.203832,0.222999,0
Charles Mynn Thruston,,,0,1,1,13,0,0,759,0,1,1,8,0.203832,0.222999,0
Executive Council of Virginia,,,0,2,2,6,0.5,0,760,0,2,2,7,0.234635,0.255408,0
"Gabriel Cerre """,,,0,1,1,13,0,0,761,0,1,1,8,0.203832,0.222999,0
General Steuben,,,0,1,1,13,0,0,762,0,1,1,8,0.203832,0.222999,0
George Meriwether,,,0,1,1,13,0,0,763,0,1,1,8,0.203832,0.222999,0
Grant of Land,,,0,1,1,13,0,0,764,0,1,1,8,0.203832,0.222999,0
H. Perrault,,,0,1,1,13,0,0,765,0,1,1,8,0.203832,0.222999,0
Inhabitants of Boonesborough,,,0,1,1,13,0,0,766,0,1,1,8,0.203832,0.222999,0
Isaac Craig,,,1,2,3,13,0,0,519,1,4,5,7,0.224066,0.245624,325.350794
J. M. P. Le Gras,,,0,2,2,13,0,0,767,0,3,3,8,0.20396,0.224026,0
James Patten,,,0,1,1,13,0,0,768,0,1,1,8,0.203832,0.222999,0
James Shelby,,,0,1,1,13,0,0,769,0,2,2,8,0.203832,0.222999,0
James Sullivan,,,0,1,1,13,0,0,770,0,2,2,8,0.203832,0.222999,0
James Willing,,,0,1,1,13,0,0,771,0,2,2,8,0.203832,0.222999,0
John Beckley,,,1,1,2,13,0,0,519,1,1,2,8,0.203902,0.223086,73.378276
John Bowman,,,0,1,1,13,0,0,772,0,2,2,8,0.203832,0.222999,0
John Campbell,,,1,1,2,4,0,0,519,1,1,2,8,0.203774,0.222957,1206.170185
John Floyd,,,0,2,2,13,1,0,773,0,7,7,8,0.222108,0.245497,0
John Gibson,,,1,2,3,13,0.333333,0,519,1,11,12,7,0.222834,0.244492,136.233333
John Rogers,,,2,3,5,13,0.333333,0,519,2,4,6,8,0.22207,0.246133,56.352597
John Todd,,,4,2,6,13,0.3,0,519,4,9,13,8,0.221918,0.245104,1330.025397
John Williams,,,0,1,1,13,0,0,774,0,1,1,8,0.203832,0.222999,0
Joseph Cesirre,,,0,1,1,13,0,0,775,0,1,1,8,0.203832,0.222999,0
Joseph Hunter,,,0,1,1,13,0,0,776,0,1,1,8,0.203832,0.222999,0
Joseph Reed,,,22,4,26,25,0.043333,0,519,41,5,46,8,0.204934,0.227818,9111.045525
Kentucky County-lieutenants,,,0,1,1,13,0,0,777,0,1,1,8,0.203832,0.222999,0
Leonard Helm,,,1,2,3,13,0,0,519,1,4,5,8,0.203774,0.2236,302
Levi Todd,,,0,1,1,13,0,0,778,0,1,1,8,0.203832,0.222999,0
Order of Council of Virginia,,,0,1,1,13,0,0,779,0,1,1,8,0.203832,0.222999,0
Petition of French Magistrates,,,0,1,1,13,0,0,780,0,1,1,8,0.203832,0.222999,0
Petition of Inhabitants of Boonesborough,,,0,1,1,13,0,0,781,0,1,1,8,0.203832,0.222999,0
Petition of Inhabitants of Bryan's Station,,,0,1,1,13,0,0,782,0,1,1,8,0.203832,0.222999,0
Pierre Dorion,,,0,1,1,13,0,0,783,0,1,1,8,0.203832,0.222999,0
Pierre Prevost,,,0,1,1,13,0,0,784,0,1,1,8,0.203832,0.222999,0
Proposed Land Grant,,,0,1,1,13,0,0,785,0,1,1,8,0.203832,0.222999,0
Registration of Land Grant,,,0,1,1,13,0,0,786,0,1,1,8,0.203832,0.222999,0
Richard Brashers,,,0,1,1,13,0,0,787,0,1,1,8,0.203832,0.222999,0
Richard Harrison,,,0,1,1,13,0,0,788,0,1,1,8,0.203832,0.222999,0
Richard Peters,,,1,2,3,13,0.333333,0,519,1,2,3,7,0.222757,0.244415,62.95
Robert Todd,,,0,1,1,13,0,0,789,0,1,1,8,0.203832,0.222999,0
Thomas Walker,,,1,1,2,13,1,0,519,1,1,2,8,0.20371,0.222828,0
Trustees at Fort Jefferson,,,0,1,1,13,0,0,790,0,1,1,8,0.203832,0.222999,0
William Bailey Smith,,,0,1,1,13,0,0,791,0,2,2,8,0.203832,0.222999,0
James Randolph Reid,,,0,4,4,6,0.083333,0,793,0,4,4,8,0.198239,0.209936,0
George Slaughter,,,5,2,7,13,0.02381,0,519,7,5,12,8,0.206633,0.224504,905.712121
John Bailey,,,0,1,1,13,0,0,794,0,1,1,9,0.171466,0.18158,0
George Thatcher,,,2,2,4,12,0.166667,0,519,5,2,7,7,0.213158,0.228035,328.97714
George W^ashington,,,1,0,1,2,0,0,132,1,0,1,0,0,0,0
George Walton,,,1,3,4,25,0.166667,0,519,1,3,4,6,0.260346,0.278729,486.083844
Committee of Arrangement,,,0,2,2,25,0,0,796,0,2,2,7,0.196493,0.209832,0
President of Congress (Elias Boudinot),,,0,1,1,25,0,0,797,0,1,1,7,0.19625,0.208614,0
President of Congress (John Hanson),,,0,1,1,25,0,0,798,0,1,1,7,0.19625,0.208614,0
654. I^Ibridge Gerry,,,0,1,1,25,0,0,799,0,1,1,7,0.19625,0.208614,0
Committee of Intelligence,,,0,1,1,25,0,0,800,0,1,1,7,0.19625,0.208614,0
Ezekiel Cornell,,,0,5,5,34,0,0,801,0,30,30,7,0.197085,0.213339,0
Henry Lee,,,1,4,5,25,0.25,0,519,1,16,17,7,0.270677,0.294154,899.508478
James Henry,,,0,1,1,25,0,0,802,0,1,1,7,0.19625,0.208614,0
John Armstrong,,,1,6,7,5,0.095238,0,519,2,24,26,7,0.23598,0.254483,1097.504762
John Banister,,,0,1,1,25,0,0,803,0,1,1,7,0.19625,0.208614,0
Jolin Hancock,,,0,1,1,25,0,0,804,0,2,2,7,0.19625,0.208614,0
Philip Schujder,,,0,1,1,25,0,0,805,0,1,1,7,0.19625,0.208614,0
Thomas Lynch,,,0,2,2,25,0.5,0,806,0,3,3,7,0.239483,0.253265,0
George Webb,,,1,0,1,13,0,0,172,1,0,1,0,0,0,0
George Weedon,,,5,0,5,5,0,0,6,10,0,10,0,0,0,0
John Walker,,,0,2,2,5,0,0,807,0,6,6,8,0.206622,0.224286,0
Mann Page jr.,,,0,1,1,5,0,0,808,0,2,2,1,1,1,0
George Wythe,,,3,1,4,13,0.25,0,519,3,1,4,8,0.206501,0.223218,0
Thomas Nelson jr.,,,0,5,5,13,0.15,0,809,0,5,5,7,0.266639,0.289849,0
GeorRC Washington,,,1,0,1,25,0,0,419,1,0,1,0,0,0,0
Gerard,,,1,0,1,25,0,0,520,1,0,1,0,0,0,0
Governor of Virginia,,,2,0,2,4,1,0,89,2,0,2,0,0,0,0
Governor Shelby,,,2,0,2,4,0.5,0,366,3,0,3,0,0,0,0
Nathaniel Mitchell,,,0,2,2,12,0,0,811,0,2,2,1,1,1,0
Gunning Bedford sr.,,,1,0,1,12,0,0,810,1,0,1,0,0,0,0
Silas Deane,,,4,7,11,1,0.054545,0,154,8,34,42,2,0.888889,0.9375,1378.2218
Gurdon Saltonstall,,,1,0,1,1,0,0,153,1,0,1,0,0,0,0
Gustave d'Ugglaa,,,1,0,1,2,0,0,125,1,0,1,0,0,0,0
Edward Abbott,,,0,1,1,13,0,0,812,0,1,1,1,1,1,0
Guy Carleton,,,2,0,2,13,0,0,506,2,0,2,0,0,0,0
Hall,,,1,0,1,5,0,0,475,1,0,1,0,0,0,0
Heads of Inquiry as to State of Army,,,1,0,1,15,0,0,270,1,0,1,0,0,0,0
Henry Acthandt,,,1,0,1,2,0,0,601,1,0,1,0,0,0,0
Samuel Osgood,,,1,8,9,5,0.083333,0,519,1,10,11,6,0.300278,0.329295,1331.898151
Henry Gardner,,,1,0,1,5,0,0,195,1,0,1,0,0,0,0
Alexander Macomb,,,0,2,2,22,0,0,814,0,2,2,2,0.75,0.833333,0
Henry Hamilton,,,2,1,3,22,0,0,28,2,1,3,1,1,1,311
R. B. Lernoult,,,1,2,3,22,0,0,29,1,2,3,2,0.75,0.833333,927
"John Armstrong, Jr.",,,1,1,2,4,0.5,0,519,1,1,2,7,0.209709,0.220139,0
John Doughty,,,0,2,2,4,0,0,815,0,2,2,7,0.209897,0.221212,0
Robert Treat Paine,,,1,3,4,4,0,0,519,1,3,4,7,0.210458,0.222788,625.166667
Rufus Putnam,,,0,1,1,4,0,0,816,0,1,1,7,0.209761,0.220185,0
William Henry Drayton,,,1,4,5,15,0.166667,0,519,2,4,6,6,0.275745,0.305787,308
Henry St. George Tucker,,,1,0,1,25,0,0,269,1,0,1,0,0,0,0
Henry Ward,,,1,0,1,12,0,0,716,6,0,6,0,0,0,0
James Manning,,,1,4,5,34,0,0,692,1,9,10,2,0.75,0.833333,11
Hezekiah Smith,,,1,0,1,34,0,0,691,2,0,2,0,0,0,0
Horatio Gates,,,30,0,30,5,0.062069,0,1,101,0,101,0,0,0,0
John Alaws,,,0,2,2,5,0,0,817,0,2,2,8,0.201303,0.211903,0
John Rutledge,,,6,3,9,15,0.125,0,143,17,3,20,1,1,1,320.094322
Richard Howly,,,1,3,4,5,0.25,0,376,1,7,8,2,0.8,0.875,0
J. G. Jones and George Rogers Clark,,,0,1,1,18,0,9,819,0,1,1,1,1,1,0
House of Delegates,,,1,0,1,18,0,9,818,1,0,1,0,0,0,0
William Samuel Johnson,,,2,6,8,21,0,0,573,8,8,16,6,0.253179,0.280949,897.046429
ICzekiel Cornell,,,1,0,1,2,0,0,445,1,0,1,0,0,0,0
Inhabitants of Monongalia County,,,1,0,1,13,0,0,498,1,0,1,0,0,0,0
John Emerson,,,0,1,1,19,0,10,821,0,1,1,1,1,1,0
Inhabitants of the west side of the Ohio River,,,1,0,1,19,0,10,820,1,0,1,0,0,0,0
Inhabitants of Vincennes,,,1,2,3,13,0,0,497,1,2,3,1,1,1,618
Isaac Hite,,,1,0,1,13,0,0,682,1,0,1,0,0,0,0
Isaac Motte,,,1,0,1,15,0,0,268,1,0,1,0,0,0,0
Israel Ludlow,,,1,0,1,4,0,0,365,3,0,3,0,0,0,0
Israel Putnam,,,2,0,2,15,0,0,267,2,0,2,0,0,0,0
Israel riitiiani,,,1,0,1,25,0,0,418,1,0,1,0,0,0,0
J. P. Le Gras,,,1,0,1,13,0,0,740,1,0,1,0,0,0,0
Jabez Huntington,,,4,0,4,21,0.083333,0,383,4,0,4,0,0,0,0
William Williams,,,4,5,9,21,0.194444,0,519,5,23,28,7,0.225705,0.244632,660.675497
Jacob Christopher Zahn,,,1,0,1,15,0,0,266,1,0,1,0,0,0,0
Jacob Wales,,,1,0,1,12,0,0,298,1,0,1,0,0,0,0
James Bowdoin,,,7,0,7,12,0.333333,0,206,16,0,16,0,0,0,0
Nathaniel Gorham,,,4,5,9,12,0.053571,0,519,5,6,11,8,0.203902,0.221059,3258.595896
James Caldwell,,,2,0,2,15,0,0,674,4,0,4,0,0,0,0
Ahraham Clark,,,0,1,1,15,0,0,822,0,1,1,1,1,1,0
James Graham,,,1,0,1,15,0,0,250,1,0,1,0,0,0,0
James Hogg,,,1,0,1,14,0,0,614,1,0,1,0,0,0,0
James Iredell,,,4,0,4,14,0.166667,0,284,20,0,20,0,0,0,0
John Swann,,,0,1,1,14,0,0,823,0,2,2,1,1,1,0
Joseph Hewes,,,1,5,6,14,0.066667,0,609,4,25,29,7,0.192764,0.205165,3.5
James Jackson,,,2,0,2,25,0,0,726,2,0,2,0,0,0,0
William Few,,,0,1,1,25,0,0,824,0,1,1,1,1,1,0
James Madison sr.,,,2,0,2,13,0,0,167,2,0,2,0,0,0,0
James Madison jr.,,,0,1,1,13,0,0,825,0,1,1,1,1,1,0
Nathan Miller,,,2,1,3,34,0,0,692,4,1,5,3,0.461538,0.527778,8
James McHenry,,,1,0,1,1,0,0,318,1,0,1,0,0,0,0
James McLene,,,1,0,1,6,0,0,650,1,0,1,0,0,0,0
James Mease,,,1,0,1,15,0,0,249,1,0,1,0,0,0,0
James Mott,,,1,0,1,15,0,0,673,1,0,1,0,0,0,0
James Nicholson,,,1,0,1,0,0,0,197,1,0,1,0,0,0,0
James Otis,,,2,0,2,5,1,0,205,2,0,2,0,0,0,0
James Searle,,,1,1,2,5,0,0,519,1,1,2,7,0.248086,0.268,275.757143
335- John Adams,,,0,1,1,5,0,0,826,0,1,1,1,1,1,0
James Warren,,,10,0,10,5,0.144444,0,158,115,0,115,0,0,0,0
SamuelAdams,,,0,1,1,5,0,0,827,0,1,1,1,1,1,0
James Young,,,1,0,1,6,0,0,745,1,0,1,0,0,0,0
Janus Caldwell,,,1,0,1,15,0,0,672,1,0,1,0,0,0,0
Jasper Yeates,,,2,0,2,6,0,0,346,2,0,2,0,0,0,0
Jean B. Laffont,,,1,0,1,13,0,0,494,1,0,1,0,0,0,0
Jean Baptiste du Coigne,,,1,0,1,4,0,0,364,1,0,1,0,0,0,0
Jean Baptiste Lazarus veneau de Francy,,,1,0,1,15,0,0,248,1,0,1,0,0,0,0
Jean de Kermovan,,,1,0,1,15,0,0,247,2,0,2,0,0,0,0
Jean Girault,,,1,0,1,13,0,0,493,1,0,1,0,0,0,0
Jehu Hay,,,1,0,1,22,0,0,813,1,0,1,0,0,0,0
Jeremiah Powell,,,5,0,5,12,0.3,0,185,28,0,28,0,0,0,0
Jeremiah Powrell,,,1,0,1,12,0,0,295,1,0,1,0,0,0,0
Jeremiah van Rensselaer,,,1,0,1,2,0,0,600,1,0,1,0,0,0,0
Jesse Root,,,0,5,5,21,0.2,0,828,0,18,18,8,0.191107,0.206328,0
Joseph Piatt Cooke,,,0,1,1,21,0,0,829,0,1,1,2,0.666667,0.75,0
Pierpont Edwards,,,0,1,1,21,0,0,830,0,2,2,2,0.666667,0.75,0
Jesse Brown,,,1,0,1,1,0,0,560,1,0,1,0,0,0,0
Jethro Sumner,,,2,0,2,14,0,0,117,3,0,3,0,0,0,0
John Augustine Washington,,,1,0,1,25,0,0,88,1,0,1,0,0,0,0
John Avery,,,3,0,3,12,0.166667,0,180,3,0,3,0,0,0,0
John Bayard,,,1,1,2,6,0,0,649,1,1,2,1,1,1,1
John Beatty,,,1,0,1,15,0,0,246,1,0,1,0,0,0,0
Meriwether Smith,,,1,3,4,13,0.083333,0,519,1,4,5,8,0.207029,0.22557,321.123016
John Bradford,,,2,0,2,5,0.5,0,417,2,0,2,0,0,0,0
John Burgoyne,,,1,0,1,15,0,0,245,1,0,1,0,0,0,0
John Cadwalader,,,1,0,1,15,0,0,244,1,0,1,0,0,0,0
David Howell,,,0,7,7,34,0.02381,0,834,0,11,11,8,0.198498,0.214523,0
John Carter,,,2,0,2,34,0,0,580,2,0,2,0,0,0,0
John Choate,,,1,0,1,12,0,0,297,1,0,1,0,0,0,0
John Clark,,,1,1,2,13,0.5,0,492,2,1,3,2,0.666667,0.75,0
John Cochran,,,1,0,1,25,0,0,511,1,0,1,0,0,0,0
Rhode Island Delegates,,,0,4,4,34,0.083333,0,836,0,37,37,2,0.833333,0.9,0
John Collins,,,5,2,7,34,0.047619,0,317,9,6,15,1,1,1,66.235256
Peleg Arnold,,,0,2,2,34,0,0,837,0,2,2,2,0.666667,0.75,0
William Blount,,,2,5,7,14,0.047619,0,571,2,25,27,1,1,1,16.5
John Cray Blount,,,1,0,1,14,0,0,570,1,0,1,0,0,0,0
John Davis,,,1,0,1,5,0,0,363,2,0,2,0,0,0,0
John McDowell,,,0,1,1,4,0,0,838,0,1,1,8,0.215902,0.22719,0
Richard Butler and Arthur Lee,,,0,1,1,4,0,0,839,0,1,1,8,0.215902,0.22719,0
John Dodge,,,1,2,3,13,0.5,0,519,1,2,3,8,0.206435,0.22399,0
John Donne,,,1,0,1,13,0,0,491,1,0,1,0,0,0,0
John Eager Howard,,,1,0,1,1,0,0,316,1,0,1,0,0,0,0
John Gray Blount,,,2,0,2,14,0.5,0,569,9,0,9,0,0,0,0
John Hall,,,3,0,3,0,0,0,5,9,0,9,0,0,0,0
Turbutt Wright,,,0,1,1,0,0,0,840,0,1,1,1,1,1,0
Samuel Livermore,,,0,4,4,24,0.25,0,841,0,38,38,8,0.20919,0.228458,0
John Hart,,,2,0,2,15,0,0,671,2,0,2,0,0,0,0
Nathaniel Scudder,,,0,3,3,5,0,0,842,0,5,5,7,0.249808,0.27256,0
John Haslet,,,2,0,2,25,0,0,12,2,0,2,0,0,0,0
John Hite,,,1,0,1,13,0,0,681,1,0,1,0,0,0,0
John Houstoun,,,1,0,1,15,0,0,243,4,0,4,0,0,0,0
John Kean,,,0,1,1,2,0,0,843,0,4,4,7,0.221577,0.235553,0
Roger Alden,,,0,3,3,21,0,0,844,0,4,4,7,0.239971,0.257631,0
John Jones,,,1,0,1,25,0,0,725,2,0,2,0,0,0,0
John Langdon,,,14,2,16,24,0.057143,0,519,70,2,72,8,0.207826,0.223703,3413.718599
Josiah Hartlctt,,,0,1,1,24,0,0,845,0,1,1,9,0.172286,0.181473,0
Josiah Rartlett,,,0,1,1,24,0,0,846,0,1,1,9,0.172286,0.181473,0
Nicholas Gilman,,,1,3,4,24,0.25,0,792,1,9,10,8,0.217712,0.233588,157.615098
Paine Wingate,,,0,5,5,24,0.1,0,849,0,13,13,7,0.22226,0.242693,0
Pierse Long,,,1,2,3,24,0.333333,0,519,1,8,9,8,0.208226,0.224282,220.813647
John Lanpdoti,,,1,0,1,24,0,0,84,1,0,1,0,0,0,0
John Lawrence,,,1,0,1,25,0,0,382,2,0,2,0,0,0,0
John Lewis Gervais,,,1,0,1,15,0,0,242,12,0,12,0,0,0,0
John Lowell,,,4,1,5,5,0,0,519,5,2,7,7,0.239822,0.257117,1132.097619
South Caroh'na Delegates,,,0,1,1,25,0,0,850,0,1,1,8,0.211884,0.22518,0
Nicholas Eveleigh,,,0,1,1,25,0,0,851,0,1,1,8,0.211884,0.22518,0
John McKesson,,,3,0,3,2,0.333333,0,130,6,0,6,0,0,0,0
John McKinley,,,1,0,1,25,0,0,416,1,0,1,0,0,0,0
John Mehelm,,,1,0,1,15,0,0,670,2,0,2,0,0,0,0
Thomas Heyward jr.,,,0,1,1,20,0,11,853,0,1,1,1,1,1,0
John Morgan,,,1,0,1,20,0,11,852,1,0,1,0,0,0,0
John Nicholson,,,3,0,3,6,0,0,109,3,0,3,0,0,0,0
William Bingham,,,5,3,8,1,0.053571,0,519,12,3,15,7,0.196245,0.209605,862.577381
John Nixon,,,1,0,1,25,0,0,415,1,0,1,0,0,0,0
John Page,,,4,1,5,13,0.25,0,519,7,1,8,9,0.181716,0.193722,44.030535
John Parke (Philopatros Philales),,,1,0,1,15,0,0,241,1,0,1,0,0,0,0
John Pickering,,,1,0,1,24,0,0,848,2,0,2,0,0,0,0
John Scollay,,,1,0,1,5,0,0,53,1,0,1,0,0,0,0
John Stark,,,1,0,1,15,0,0,238,1,0,1,0,0,0,0
John Stevens,,,2,0,2,15,0,0,669,3,0,3,0,0,0,0
John Taliaferro,,,1,0,1,13,0,0,162,1,0,1,0,0,0,0
John Thomas,,,1,0,1,25,0,0,414,1,0,1,0,0,0,0
Richard McCarty,,,0,1,1,13,0,0,854,0,1,1,9,0.181844,0.193938,0
John Trumbull,,,1,0,1,5,0,0,184,1,0,1,0,0,0,0
John Tyler,,,1,0,1,13,0,0,171,1,0,1,0,0,0,0
John Vining,,,1,0,1,1,0,0,315,1,0,1,0,0,0,0
John Wendell,,,2,0,2,21,0,0,86,5,0,5,0,0,0,0
John Winthrop,,,2,0,2,5,1,0,52,3,0,3,0,0,0,0
Jonathan Clark,,,4,1,5,13,0.15,0,490,12,1,13,1,1,1,311
John B. Roy,,,0,1,1,13,0,0,855,0,1,1,2,0.666667,0.75,0
Jonathan Jackson,,,1,0,1,21,0,0,302,3,0,3,0,0,0,0
Jonathan Potts,,,1,0,1,25,0,0,410,1,0,1,0,0,0,0
Jonathan Trumbull,,,17,0,17,21,0.095588,0,51,128,0,128,0,0,0,0
Connecticut Delegates,,,0,7,7,21,0.071429,0,857,0,36,36,7,0.241098,0.270619,0
Richard Law,,,0,1,1,21,0,0,858,0,1,1,1,1,1,0
Titus Hosmer,,,1,1,2,21,0,0,148,1,2,3,1,1,1,2
Jonathan Trumbull jr.,,,11,0,11,21,0.118182,0,152,18,0,18,0,0,0,0
Jonathan Trumbull sr.,,,4,0,4,21,0,0,151,10,0,10,0,0,0,0
Joseph Clay,,,3,0,3,14,0,0,237,3,0,3,0,0,0,0
Joseph Crockett,,,1,1,2,13,0,0,519,1,1,2,8,0.206238,0.222704,0
Joseph Frye,,,1,0,1,25,0,0,413,1,0,1,0,0,0,0
Joseph Hawkey,,,1,0,1,21,0,0,175,1,0,1,0,0,0,0
Joseph Hawley,,,2,0,2,21,0,0,204,3,0,3,0,0,0,0
Joseph Martin,,,1,0,1,13,0,0,505,1,0,1,0,0,0,0
Joseph Palmer,,,3,0,3,5,1,0,50,7,0,7,0,0,0,0
Joseph Priestley,,,1,0,1,6,0,0,518,1,0,1,0,0,0,0
Jared Ingersoll,,,0,1,1,25,0,0,859,0,1,1,9,0.170297,0.182178,0
Samuel John Atlee,,,0,1,1,25,0,0,860,0,1,1,9,0.170297,0.182178,0
Committee of CoiiRress,,,0,1,1,21,0,0,861,0,1,1,1,1,1,0
Joseph Trumbull,,,15,0,15,21,0.07619,0,49,84,0,84,0,0,0,0
James Lowell,,,0,3,3,21,0,0,863,0,4,4,7,0.225694,0.243238,0
Klhrid Kcderry,,,0,1,1,21,0,0,864,0,1,1,1,1,1,0
Kliphalet Dyer,,,0,1,1,21,0,0,865,0,1,1,1,1,1,0
Joseph Wanton,,,1,0,1,12,0,0,715,1,0,1,0,0,0,0
Joseph Warren,,,3,0,3,5,0.5,0,48,4,0,4,0,0,0,0
Joshua Coit,,,1,0,1,4,0,0,362,1,0,1,0,0,0,0
Joshua Huntington,,,1,0,1,21,0,0,353,1,0,1,0,0,0,0
Josia Beall,,,1,0,1,25,0,0,401,1,0,1,0,0,0,0
George Frost,,,0,1,1,24,0,0,866,0,3,3,8,0.174791,0.183225,0
John Taylor Gilman,,,0,3,3,24,0.166667,0,868,0,22,22,8,0.175061,0.185251,0
Nathaniel Folsom,,,2,3,5,24,0.5,0,519,4,17,21,7,0.218035,0.235038,394.7
Phillips White,,,0,2,2,24,0.5,0,869,0,3,3,8,0.174838,0.183996,0
John Armstrong Jr.,,,0,1,1,4,0,0,870,0,1,1,7,0.22732,0.239211,0
Lieutenant Denny,,,0,1,1,4,0,0,871,0,1,1,7,0.22732,0.239211,0
Philip Liebert,,,0,1,1,4,0,0,872,0,1,1,7,0.22732,0.239211,0
Josiah Hornblower,,,2,0,2,15,0,0,668,2,0,2,0,0,0,0
Abrahant Gark,,,0,1,1,15,0,0,873,0,1,1,1,1,1,0
Josiah Quincy,,,2,0,2,6,0,0,203,2,0,2,0,0,0,0
Judge Addison,,,1,0,1,4,0,0,361,1,0,1,0,0,0,0
Judge McMillan,,,1,0,1,4,0,0,65,1,0,1,0,0,0,0
Judge Varnum,,,1,0,1,4,0,0,360,1,0,1,0,0,0,0
Judges,,,1,0,1,4,0,0,359,1,0,1,0,0,0,0
Judges of Hamilton County,,,1,0,1,4,0,0,358,1,0,1,0,0,0,0
Justin Ely,,,1,0,1,12,0,0,296,1,0,1,0,0,0,0
Kentucky County Commissioners,,,1,0,1,13,0,0,488,1,0,1,0,0,0,0
Lachlan Mcintosh,,,2,0,2,15,0,0,236,4,0,4,0,0,0,0
Carter Braxton,,,0,1,1,5,0,0,874,0,2,2,1,1,1,0
Landon Carter,,,3,0,3,5,0.333333,0,474,10,0,10,0,0,0,0
Thomas Nelson,,,6,1,7,13,0.047619,0,18,20,1,21,1,1,1,309
Leighton Wood,,,1,0,1,13,0,0,17,1,0,1,0,0,0,0
Lewis Pintard,,,1,0,1,15,0,0,735,7,0,7,0,0,0,0
Lord Howe,,,2,0,2,6,0,0,473,2,0,2,0,0,0,0
Lord Stirling,,,5,0,5,15,0.25,0,56,12,0,12,0,0,0,0
William Livingston,,,13,2,15,15,0.066667,0,57,37,4,41,1,1,1,398.185714
Louis Fleury,,,1,0,1,15,0,0,235,1,0,1,0,0,0,0
Luke Decker,,,1,0,1,4,0,0,357,1,0,1,0,0,0,0
Luzerne,,,1,0,1,13,0,0,496,1,0,1,0,0,0,0
Major Cracraft,,,1,0,1,13,0,0,487,1,0,1,0,0,0,0
Major Murray,,,1,0,1,4,0,0,356,1,0,1,0,0,0,0
Major Wythellys,,,2,0,2,4,0,0,355,2,0,2,0,0,0,0
Marinus Willett,,,1,0,1,2,0,0,257,1,0,1,0,0,0,0
Maryland,,,1,0,1,25,0,0,381,1,0,1,0,0,0,0
Mason Bolton,,,1,0,1,22,0,0,26,1,0,1,0,0,0,0
Matthew Griswold,,,3,0,3,21,0.5,0,352,5,0,5,0,0,0,0
Matthew Locke,,,1,0,1,14,0,0,686,1,0,1,0,0,0,0
Matthew Thornton,,,2,1,3,24,0.333333,0,85,4,1,5,1,1,1,1.5
May,,,1,0,1,5,0,0,472,1,0,1,0,0,0,0
Engagement of Members,,,0,1,1,23,0,12,876,0,1,1,1,1,1,0
Meet Punctually etc.,,,1,0,1,23,0,12,875,1,0,1,0,0,0,0
Memoranda,,,1,0,1,15,0,0,234,1,0,1,0,0,0,0
Memorandum,,,3,0,3,15,0.5,0,233,7,0,7,0,0,0,0
Memorandum of Conference with Gerard,,,1,0,1,15,0,0,104,1,0,1,0,0,0,0
Memorial to Congress,,,1,0,1,2,0,0,444,1,0,1,0,0,0,0
Mercy Warren,,,1,0,1,5,0,0,202,1,0,1,0,0,0,0
Meschech Weare,,,1,0,1,24,0,0,867,1,0,1,0,0,0,0
Meshech Weare,,,15,0,15,24,0.095238,0,83,121,0,121,0,0,0,0
533- William Whipple,,,0,1,1,24,0,0,877,0,1,1,1,1,1,0
Woodbury Langdon,,,1,2,3,24,0.5,0,519,1,3,4,7,0.217596,0.233109,0
Militia,,,1,0,1,13,0,0,486,1,0,1,0,0,0,0
Minute,,,2,0,2,25,0,0,292,4,0,4,0,0,0,0
Minutes,,,1,0,1,25,0,0,747,15,0,15,0,0,0,0
Minutes of Debates,,,1,0,1,15,0,0,232,1,0,1,0,0,0,0
Minutes of Proceedings,,,2,0,2,1,0,0,231,4,0,4,0,0,0,0
Miss Mercy Scollay,,,1,0,1,5,0,0,47,1,0,1,0,0,0,0
Monsieur Aycard,,,1,0,1,1,0,0,314,1,0,1,0,0,0,0
Moore Furman,,,2,0,2,15,0,0,63,2,0,2,0,0,0,0
William Churchill Houston,,,4,5,9,15,0.097222,0,519,5,11,16,7,0.256532,0.279685,1540.929943
William Carmichael,,,2,4,6,0,0.033333,0,557,2,4,6,9,0.148461,0.157981,11.5
Mordecai Gist,,,1,0,1,0,0,0,556,1,0,1,0,0,0,0
Moses Brown,,,1,0,1,34,0,0,833,2,0,2,0,0,0,0
Moses Gill,,,1,0,1,5,0,0,201,1,0,1,0,0,0,0
Motion,,,4,0,4,13,0.25,0,103,5,0,5,0,0,0,0
Mrs. Abigail Adams,,,3,0,3,5,0.666667,0,46,58,0,58,0,0,0,0
Mrs. Boudinot,,,1,0,1,15,0,0,734,2,0,2,0,0,0,0
Mrs. Cushing,,,1,0,1,21,0,0,593,1,0,1,0,0,0,0
Mrs. Deane,,,1,0,1,1,0,0,150,25,0,25,0,0,0,0
Mrs. Duane,,,1,0,1,2,0,0,256,5,0,5,0,0,0,0
Mrs. Elizabeth Dana,,,1,0,1,5,0,0,183,1,0,1,0,0,0,0
Mrs. Gates,,,1,0,1,2,0,0,596,1,0,1,0,0,0,0
Mrs. Hancock,,,1,0,1,25,0,0,412,4,0,4,0,0,0,0
Mrs. Izard,,,1,0,1,1,0,0,558,1,0,1,0,0,0,0
Mrs. McKean,,,1,0,1,25,0,0,510,3,0,3,0,0,0,0
Mrs. Read,,,1,0,1,25,0,0,13,7,0,7,0,0,0,0
Mrs. Reed,,,1,0,1,25,0,0,349,2,0,2,0,0,0,0
Mrs. Rodney,,,1,0,1,12,0,0,10,1,0,1,0,0,0,0
Mrs. Susannah Connolly,,,1,0,1,25,0,0,411,1,0,1,0,0,0,0
Mrs. Wolcott,,,1,0,1,21,0,0,351,21,0,21,0,0,0,0
Nanaloibi,,,1,0,1,13,0,0,485,1,0,1,0,0,0,0
Nathan Brownson,,,1,0,1,25,0,0,509,1,0,1,0,0,0,0
Nathanacl Greene,,,1,0,1,5,0,0,200,1,0,1,0,0,0,0
Nathanael Greene,,,17,0,17,25,0.051471,0,97,48,0,48,0,0,0,0
Ministar of War,,,0,1,1,25,0,0,878,0,1,1,1,1,1,0
Nathaniel Greene,,,2,0,2,34,0,0,379,2,0,2,0,0,0,0
John ^laws,,,0,1,1,24,0,0,879,0,1,1,7,0.217712,0.23275,0
Nathaniel Wcodhull,,,1,0,1,2,0,0,443,1,0,1,0,0,0,0
Nathaniel Woodhull,,,1,0,1,2,0,0,442,1,0,1,0,0,0,0
Natlianiel Peabody,,,1,0,1,5,0,0,182,1,0,1,0,0,0,0
Nicholas Cooke,,,9,0,9,34,0,0,230,30,0,30,0,0,0,0
Stephen Hopkins,,,0,1,1,34,0,0,880,0,1,1,1,1,1,0
William Ellcry,,,0,1,1,34,0,0,881,0,1,1,1,1,1,0
William EUery,,,0,1,1,34,0,0,882,0,1,1,1,1,1,0
William McGilivry,,,0,1,1,34,0,0,883,0,1,1,1,1,1,0
John Henry jr.,,,0,3,3,0,0,0,885,0,9,9,9,0.148165,0.156429,0
Nicholas Thomas,,,1,0,1,0,0,0,884,2,0,2,0,0,0,0
Note,,,3,0,3,21,0.166667,0,76,3,0,3,0,0,0,0
Thomas Johnson,,,2,1,3,1,0,0,306,2,1,3,1,1,1,310
Note on Franklin's Articles of Confederation,,,1,0,1,1,0,0,305,1,0,1,0,0,0,0
Notes,,,1,0,1,15,0,0,229,9,0,9,0,0,0,0
Notes for RMarks,,,1,0,1,15,0,0,228,1,0,1,0,0,0,0
Notes of Debates,,,5,0,5,1,0.15,0,199,34,0,34,0,0,0,0
Notes of Proceedings,,,2,0,2,15,1,0,227,13,0,13,0,0,0,0
Notes on Articles of Confederation,,,1,0,1,14,0,0,114,1,0,1,0,0,0,0
Notes on Burgoyne's Letter to Gates,,,1,0,1,15,0,0,226,1,0,1,0,0,0,0
Notes on his Letter of Resignation,,,1,0,1,15,0,0,225,1,0,1,0,0,0,0
Notes on Measure for Half-Pay,,,1,0,1,15,0,0,224,1,0,1,0,0,0,0
Notes on State of Colonies,,,1,0,1,2,0,0,255,1,0,1,0,0,0,0
Observations,,,1,0,1,13,0,0,160,1,0,1,0,0,0,0
Officers of Pennsylvania and Virginia,,,1,0,1,13,0,0,484,1,0,1,0,0,0,0
Joseph Spencer,,,0,1,1,21,0,0,886,0,1,1,10,0.146468,0.155826,0
Oliver Pollock,,,4,0,4,13,0.166667,0,483,6,0,6,0,0,0,0
Oliver Tollock,,,1,0,1,1,0,0,563,1,0,1,0,0,0,0
Oliver Wolcott jr.,,,1,0,1,21,0,0,574,2,0,2,0,0,0,0
Part of a Speech in Congress upon Confederation,,,1,0,1,15,0,0,546,1,0,1,0,0,0,0
Paul Revere,,,1,0,1,5,0,0,45,1,0,1,0,0,0,0
Pennsylvania Delegates to U.S. Congress,,,1,0,1,4,0,0,192,1,0,1,0,0,0,0
People of Illinois,,,1,0,1,22,0,0,27,1,0,1,0,0,0,0
People of Kaskaskia,,,1,0,1,13,0,0,30,1,0,1,0,0,0,0
Peter Grubb,,,1,0,1,4,0,0,216,1,0,1,0,0,0,0
Peter Muhlenberg,,,3,0,3,6,0,0,538,4,0,4,0,0,0,0
Peter T. Curtenius,,,1,0,1,2,0,0,124,1,0,1,0,0,0,0
Peter Thacher,,,1,0,1,5,0,0,44,1,0,1,0,0,0,0
Peter Wilson,,,1,0,1,15,0,0,733,1,0,1,0,0,0,0
Philip Mazzei,,,1,0,1,6,0,0,517,1,0,1,0,0,0,0
Pierre Etienne Duponceau,,,1,0,1,15,0,0,223,1,0,1,0,0,0,0
Pierre Van Cortlandt,,,3,0,3,2,0.333333,0,254,4,0,4,0,0,0,0
Proceedings,,,1,0,1,25,0,0,531,3,0,3,0,0,0,0
Proposed Amendment,,,1,0,1,15,0,0,222,1,0,1,0,0,0,0
Proposed Amendments to Constitution,,,1,0,1,5,0,0,471,1,0,1,0,0,0,0
Proposed Entry in Journals,,,1,0,1,1,0,0,319,1,0,1,0,0,0,0
Proposed Motion,,,1,0,1,2,0,0,128,1,0,1,0,0,0,0
Proposed Report,,,2,0,2,15,0,0,62,2,0,2,0,0,0,0
Proposed Resolution,,,3,0,3,6,0,0,221,3,0,3,0,0,0,0
Proposed Resolutions,,,2,0,2,6,0,0,441,2,0,2,0,0,0,0
Proposed Resolve,,,3,0,3,6,0.333333,0,220,3,0,3,0,0,0,0
Proposed Resolves,,,3,0,3,15,0.166667,0,127,3,0,3,0,0,0,0
Propositions before Committee on Rights,,,1,0,1,2,0,0,253,1,0,1,0,0,0,0
Propositions for Treaty of Peace,,,1,0,1,4,0,0,191,1,0,1,0,0,0,0
Qement Nash,,,1,0,1,25,0,0,378,1,0,1,0,0,0,0
Rawlins Lowndes,,,3,0,3,15,0,0,123,21,0,21,0,0,0,0
Remarks,,,1,0,1,15,0,0,219,1,0,1,0,0,0,0
Reminiscences,,,1,0,1,15,0,0,732,1,0,1,0,0,0,0
Report,,,7,0,7,25,0.02381,0,113,10,0,10,0,0,0,0
Examination of William Carmichael,,,0,1,1,25,0,0,887,0,3,3,1,1,1,0
Proceedings and Observations of Committee of Finance,,,0,1,1,25,0,0,888,0,1,1,1,1,1,0
Report on Memorial for General Montgomery,,,1,0,1,25,0,0,723,1,0,1,0,0,0,0
Report to Provincial Congress,,,1,0,1,15,0,0,618,1,0,1,0,0,0,0
Resolution,,,1,0,1,15,0,0,291,1,0,1,0,0,0,0
Resolution proposed in Committee on Rights,,,1,0,1,15,0,0,142,1,0,1,0,0,0,0
Rev. James Cogswell,,,1,0,1,25,0,0,377,1,0,1,0,0,0,0
Richard Bache,,,1,0,1,12,0,0,82,1,0,1,0,0,0,0
Richard Butler,,,1,0,1,1,0,0,313,1,0,1,0,0,0,0
Richard Caswell,,,20,0,20,14,0.036842,0,112,102,0,102,0,0,0,0
John Baptiste Ashe,,,0,1,1,14,0,0,889,0,1,1,1,1,1,0
Thomas Polk,,,0,1,1,14,0,0,890,0,1,1,1,1,1,0
Thomas Rurke,,,0,1,1,14,0,0,891,0,1,1,1,1,1,0
Whitmill Hill,,,0,2,2,14,0.5,0,892,0,4,4,6,0.236775,0.252131,0
William Cumming,,,0,1,1,14,0,0,893,0,1,1,1,1,1,0
William Gumming,,,0,1,1,14,0,0,894,0,1,1,1,1,1,0
Robert Burton,,,0,1,1,26,0,13,896,0,1,1,1,1,1,0
Richard Caswrll,,,1,0,1,26,0,13,895,1,0,1,0,0,0,0
Richard Claiborne,,,1,0,1,1,0,0,312,1,0,1,0,0,0,0
Richard Dallam,,,1,0,1,25,0,0,463,1,0,1,0,0,0,0
Richard Dobbs Spaight,,,1,0,1,1,0,0,311,1,0,1,0,0,0,0
Richard Flenry Lee,,,1,0,1,13,0,0,504,1,0,1,0,0,0,0
William Shippen,,,1,1,2,5,0,0,519,1,1,2,7,0.247801,0.267537,0
Richard Jackson,,,1,0,1,21,0,0,567,1,0,1,0,0,0,0
Richard Lee,,,1,0,1,5,0,0,470,2,0,2,0,0,0,0
Richard Montgomery,,,1,0,1,25,0,0,59,1,0,1,0,0,0,0
Richard Varick,,,1,0,1,2,0,0,409,1,0,1,0,0,0,0
Richard Winn,,,1,0,1,1,0,0,310,1,0,1,0,0,0,0
Robert Christie,,,1,0,1,0,0,0,4,1,0,1,0,0,0,0
Robert Howe,,,1,0,1,15,0,0,218,2,0,2,0,0,0,0
Robert Montgomery,,,1,0,1,2,0,0,252,1,0,1,0,0,0,0
Robert Purviance,,,3,0,3,14,0,0,217,3,0,3,0,0,0,0
Roderique Hortales and Company,,,1,0,1,15,0,0,214,1,0,1,0,0,0,0
S. P. Eve,,,1,0,1,4,0,0,215,1,0,1,0,0,0,0
Samuel Adams Wells,,,1,0,1,13,0,0,503,1,0,1,0,0,0,0
Samuel Brown,,,1,0,1,13,0,0,25,1,0,1,0,0,0,0
Samuel Cooper,,,1,0,1,5,0,0,43,6,0,6,0,0,0,0
Samuel H. Parsons,,,1,0,1,4,0,0,68,1,0,1,0,0,0,0
Samuel Hardy,,,1,0,1,1,0,0,309,7,0,7,0,0,0,0
Samuel Hodgdon,,,1,0,1,4,0,0,67,1,0,1,0,0,0,0
Samuel Hoi ten,,,1,0,1,5,0,0,181,1,0,1,0,0,0,0
Samuel Holden Parsons,,,1,0,1,5,0,0,196,1,0,1,0,0,0,0
Richard Potts,,,0,2,2,0,0,0,898,0,2,2,1,1,1,0
Samuel Hughes,,,1,0,1,0,0,0,897,1,0,1,0,0,0,0
Commitlee at Headquarters,,,0,1,1,25,0,0,899,0,1,1,7,0.240104,0.264873,0
Jonathan Sturges,,,0,1,1,25,0,0,900,0,1,1,7,0.240104,0.264873,0
President of Congress (Cyrus Griffin),,,0,1,1,14,0,0,901,0,1,1,7,0.192069,0.200781,0
Samuel Jones,,,1,0,1,34,0,0,690,2,0,2,0,0,0,0
Samuel Lane,,,1,0,1,24,0,0,847,4,0,4,0,0,0,0
Samuel Lyman,,,3,0,3,21,0.5,0,71,9,0,9,0,0,0,0
Samuel McDowell,,,1,0,1,1,0,0,308,1,0,1,0,0,0,0
Samuel Phillips,,,1,0,1,12,0,0,81,1,0,1,0,0,0,0
Samuel Phillips Savage,,,1,0,1,5,0,0,42,3,0,3,0,0,0,0
Samuel Purviance,,,4,0,4,14,0,0,155,5,0,5,0,0,0,0
Samuel Purviance jr.,,,2,0,2,5,0,0,41,4,0,4,0,0,0,0
Samuel Tucker,,,4,0,4,15,0.166667,0,55,5,0,5,0,0,0,0
New Jersey Delegates,,,0,2,2,15,0.5,0,902,0,2,2,2,0.75,0.833333,0
Samuel William Johnson,,,1,0,1,21,0,0,566,2,0,2,0,0,0,0
Secretary of State,,,2,0,2,4,0.5,0,64,2,0,2,0,0,0,0
William Bradford,,,0,1,1,27,0,14,904,0,1,1,1,1,1,0
Secretary of the Treasury,,,1,0,1,27,0,14,903,1,0,1,0,0,0,0
Sellers,,,1,0,1,5,0,0,40,1,0,1,0,0,0,0
Silas Dayton,,,1,0,1,13,0,0,489,1,0,1,0,0,0,0
Silas Martin,,,1,0,1,13,0,0,24,1,0,1,0,0,0,0
Sir James Jay,,,1,0,1,5,0,0,39,1,0,1,0,0,0,0
Land Grants,,,0,1,1,28,0,15,906,0,1,1,1,1,1,0
Soldiers,,,1,0,1,28,0,15,905,1,0,1,0,0,0,0
Speaker of the House of Delegates,,,1,0,1,13,0,0,502,1,0,1,0,0,0,0
Speech,,,2,0,2,15,0,0,126,3,0,3,0,0,0,0
Speech before New Jersey Assembly,,,1,0,1,1,0,0,323,1,0,1,0,0,0,0
Speech in Congress,,,1,0,1,21,0,0,565,1,0,1,0,0,0,0
Speech on Convention with Burgoyne,,,2,0,2,15,0,0,111,2,0,2,0,0,0,0
Speech on Finances,,,1,0,1,15,0,0,545,1,0,1,0,0,0,0
Speech on Loan-Office Certificates,,,1,0,1,15,0,0,544,1,0,1,0,0,0,0
Statement,,,9,0,9,15,0.027778,0,38,14,0,14,0,0,0,0
Joseph Galloway,,,0,4,4,29,0,0,910,0,9,9,1,1,1,0
Statement relative to his plan of Union,,,1,0,1,29,0,0,909,2,0,2,0,0,0,0
Statement to a Committee of House of Commons,,,1,0,1,29,0,0,908,4,0,4,0,0,0,0
Stephen Drayton,,,1,0,1,15,0,0,147,1,0,1,0,0,0,0
Stephen Higginson,,,1,0,1,12,0,0,80,1,0,1,0,0,0,0
Stephen Sayre,,,1,0,1,2,0,0,595,1,0,1,0,0,0,0
Stephen Ward,,,1,0,1,2,0,0,122,1,0,1,0,0,0,0
Sundry Printers,,,1,0,1,1,0,0,307,1,0,1,0,0,0,0
Tapping Reeve,,,1,0,1,21,0,0,70,1,0,1,0,0,0,0
the Board of War,,,1,0,1,25,0,0,87,1,0,1,0,0,0,0
the Governor of Virginia,,,1,0,1,13,0,0,495,1,0,1,0,0,0,0
Theoderick Bland,,,1,0,1,25,0,0,795,1,0,1,0,0,0,0
Theophilus Parsons,,,2,0,2,12,0,0,75,2,0,2,0,0,0,0
John Matthews,,,0,1,1,25,0,0,911,0,1,1,3,0.5,0.583333,0
Thomas Blount,,,1,0,1,14,0,0,568,1,0,1,0,0,0,0
Thomas Bradford,,,1,0,1,25,0,0,508,1,0,1,0,0,0,0
Thomas Carder Hazard,,,1,0,1,34,0,0,832,1,0,1,0,0,0,0
Thomas Chittenden,,,1,0,1,15,0,0,731,1,0,1,0,0,0,0
Thomas Collins,,,3,0,3,12,0.166667,0,9,3,0,3,0,0,0,0
Thomas Dwight,,,1,0,1,12,0,0,78,2,0,2,0,0,0,0
Samuel Meredith,,,0,1,1,13,0,0,912,0,1,1,7,0.195836,0.207202,0
Thomas Gushing,,,2,0,2,6,0,0,551,2,0,2,0,0,0,0
Thomas Harwood,,,1,0,1,0,0,0,555,1,0,1,0,0,0,0
Thomas Hurke,,,1,0,1,14,0,0,116,1,0,1,0,0,0,0
Thomas Ivers,,,2,0,2,12,1,0,77,2,0,2,0,0,0,0
Garret Van Meter,,,0,1,1,13,0,0,913,0,1,1,8,0.206425,0.223131,0
John Harvie,,,0,1,1,13,0,0,914,0,2,2,8,0.206425,0.223131,0
Officers of Berkley County,,,0,1,1,13,0,0,915,0,1,1,8,0.206425,0.223131,0
Officers of Greenbrier County,,,0,1,1,13,0,0,916,0,1,1,8,0.206425,0.223131,0
William Fleming,,,1,1,2,13,1,0,519,2,5,7,8,0.206304,0.222961,0
Daniel Robcrdcau,,,0,1,1,1,0,0,917,0,1,1,2,0.666667,0.75,0
Committee on Commissary and Quartermaster's Departments,,,0,1,1,0,0,0,918,0,1,1,9,0.147903,0.154102,0
James Forbes,,,0,3,3,0,0,0,919,0,4,4,9,0.148038,0.156157,0
John Henry,,,0,2,2,0,0,0,920,0,4,4,9,0.148106,0.155423,0
John Henryjr.,,,0,1,1,0,0,0,921,0,1,1,9,0.147903,0.154102,0
Thomas Lee Shippen,,,1,0,1,5,0,0,37,1,0,1,0,0,0,0
Thomas Mifflin,,,4,0,4,13,0.083333,0,36,5,0,5,0,0,0,0
Henjamin Rush,,,0,1,1,30,0,16,923,0,1,1,1,1,1,0
Thomas Morris,,,1,0,1,30,0,16,922,1,0,1,0,0,0,0
Thomas Mumford,,,1,0,1,1,0,0,149,1,0,1,0,0,0,0
Thomas Person,,,1,0,1,14,0,0,239,2,0,2,0,0,0,0
Thomas Pinckney,,,1,0,1,15,0,0,617,3,0,3,0,0,0,0
John Morton,,,0,1,1,31,0,17,925,0,1,1,1,1,1,0
Thomas Powell,,,1,0,1,31,0,17,924,1,0,1,0,0,0,0
Nicholas Van Dyke,,,0,1,1,12,0,0,926,0,2,2,4,0.391304,0.462963,0
Thomas Sim Lee,,,11,0,11,0,0.027273,0,3,43,0,43,0,0,0,0
Thomas Sinnickson,,,1,0,1,15,0,0,667,1,0,1,0,0,0,0
Thomas Waring,,,1,0,1,25,0,0,375,1,0,1,0,0,0,0
Thomas Wharton jr.,,,7,0,7,6,0.02381,0,0,25,0,25,0,0,0,0
Thomas Willing,,,1,0,1,1,0,0,108,1,0,1,0,0,0,0
Timothy Danielson,,,1,0,1,12,0,0,550,1,0,1,0,0,0,0
Timothy Edwards,,,1,0,1,21,0,0,69,1,0,1,0,0,0,0
Timothy Matlack,,,4,0,4,6,0,0,110,5,0,5,0,0,0,0
William Henry Draj^ton,,,0,1,1,6,0,0,927,0,1,1,1,1,1,0
to Horatio Gates,,,1,0,1,6,0,0,654,1,0,1,0,0,0,0
John Wentworth jr.,,,0,1,1,32,0,18,929,0,1,1,1,1,1,0
to John Langdon,,,1,0,1,32,0,18,928,1,0,1,0,0,0,0
to William Irvine,,,1,0,1,6,0,0,653,1,0,1,0,0,0,0
Treasurer of Virginia,,,1,0,1,13,0,0,23,1,0,1,0,0,0,0
Udny Hay,,,1,0,1,2,0,0,440,1,0,1,0,0,0,0
unknown,,,13,0,13,0,0,0,2,17,0,17,0,0,0,0
One of Virginia Delegates,,,0,1,1,0,0,0,930,0,4,4,1,1,1,0
Proposal for Treaty with Great Britain,,,0,1,1,0,0,0,931,0,1,1,1,1,1,0
William Hindman,,,0,1,1,0,0,0,932,0,1,1,1,1,1,0
Vicomte dv Mauroy,,,1,0,1,21,0,0,862,1,0,1,0,0,0,0
Virginia Delegates in Congress,,,1,0,1,5,0,0,31,1,0,1,0,0,0,0
Walter Livingston,,,2,0,2,1,0,0,251,3,0,3,0,0,0,0
Pierce Butler,,,0,1,1,33,0,19,934,0,1,1,1,1,1,0
Weedon Butler,,,1,0,1,33,0,19,933,1,0,1,0,0,0,0
Welcome Arnold,,,2,0,2,34,0,0,831,4,0,4,0,0,0,0
William Alexander,,,1,0,1,6,0,0,72,1,0,1,0,0,0,0
William Augustus Atlee,,,3,0,3,25,0,0,8,6,0,6,0,0,0,0
William Aylett,,,1,0,1,15,0,0,107,1,0,1,0,0,0,0
William Barton,,,1,0,1,1,0,0,304,1,0,1,0,0,0,0
William Bruff,,,1,0,1,0,0,0,523,1,0,1,0,0,0,0
William Cooper,,,1,0,1,25,0,0,58,1,0,1,0,0,0,0
William Cushing,,,1,0,1,5,0,0,179,1,0,1,0,0,0,0
Edward Langworthy,,,0,1,1,2,0,0,935,0,1,1,7,0.212488,0.222703,0
William Franklin,,,1,0,1,29,0,0,907,2,0,2,0,0,0,0
William Glascock,,,1,0,1,2,0,0,121,1,0,1,0,0,0,0
William Green,,,1,0,1,34,0,0,835,1,0,1,0,0,0,0
William Greene,,,9,0,9,34,0.041667,0,61,87,0,87,0,0,0,0
Jonathan Arnold,,,0,1,1,34,0,0,936,0,3,3,1,1,1,0
William Harrod,,,1,0,1,13,0,0,22,2,0,2,0,0,0,0
William Heath,,,6,0,6,15,0.3,0,7,18,0,18,0,0,0,0
William Heth,,,1,0,1,13,0,0,657,1,0,1,0,0,0,0
William Hunt,,,1,0,1,21,0,0,174,1,0,1,0,0,0,0
William Judd,,,1,0,1,21,0,0,385,1,0,1,0,0,0,0
William Lee,,,2,0,2,5,0,0,35,5,0,5,0,0,0,0
William Malcom,,,1,0,1,15,0,0,102,1,0,1,0,0,0,0
William Maxwell,,,4,0,4,5,0.166667,0,34,4,0,4,0,0,0,0
William Mayo,,,1,0,1,13,0,0,21,1,0,1,0,0,0,0
William Moore,,,1,0,1,1,0,0,73,1,0,1,0,0,0,0
William Moultrie,,,2,0,2,15,0,0,101,2,0,2,0,0,0,0
William Myers,,,1,0,1,13,0,0,20,1,0,1,0,0,0,0
William Palfrey,,,2,0,2,25,1,0,54,2,0,2,0,0,0,0
William Phillips,,,1,0,1,1,0,0,289,1,0,1,0,0,0,0
William Pitkin,,,1,0,1,25,0,0,60,1,0,1,0,0,0,0
William Plumer,,,1,0,1,5,0,0,178,1,0,1,0,0,0,0
William Preston,,,1,0,1,13,0,0,19,2,0,2,0,0,0,0
William Shippen jr.,,,2,0,2,5,0,0,33,3,0,3,0,0,0,0
William Short,,,5,0,5,13,0.3,0,74,7,0,7,0,0,0,0
William Pierce,,,0,2,2,13,0,0,938,0,2,2,1,1,1,0
William Smallwood,,,5,0,5,0,0,0,100,12,0,12,0,0,0,0
Nathaniel Ramsey,,,0,1,1,0,0,0,939,0,1,1,1,1,1,0
William Harrison,,,0,1,1,0,0,0,940,0,1,1,1,1,1,0
William Smith,,,1,0,1,15,0,0,99,1,0,1,0,0,0,0
William Thomson,,,1,0,1,15,0,0,98,1,0,1,0,0,0,0
William Tokeley,,,1,0,1,14,0,0,608,1,0,1,0,0,0,0
William Tudor,,,1,0,1,5,0,0,177,2,0,2,0,0,0,0
William Vernon,,,1,0,1,34,0,0,689,2,0,2,0,0,0,0
William Washington,,,1,0,1,13,0,0,937,1,0,1,0,0,0,0
William Wilkinson,,,1,0,1,14,0,0,115,4,0,4,0,0,0,0
William Woodford,,,2,0,2,14,0,0,163,4,0,4,0,0,0,0
Zabdiel Adams,,,1,0,1,5,0,0,176,1,0,1,0,0,0,0
Zebulon Butler,,,1,0,1,21,0,0,386,1,0,1,0,0,0,0
Zebulon Butler and Ors,,,1,0,1,21,0,0,856,1,0,1,0,0,0,0
